"<The> Blind heart.-- Harper, 1964"	Jamesan	 Margaret Storm
"<The> Blood morphology of laboratory animals.-- F.A. Davis, 1967"	Schermer	 Siegmund
"<The> Blue Nile.-- Harper, 1962"	Moorehead	 Alan
"<The> book of Chilam Balam of Chumayel.-- Carnegie Institution of Washington, 1933"	Chilam Balam Books. Chumayel Book	
"<The> book of Duarte Barbosa.-- Hakluyt Society, 1921"	Dames	 mnsel Longworth
"<The> book of the jaguar priest, a translation of the book of chilam balam of tizimin.-- Schuman, 1951"	Chilam Balam Books. Tizimin Book	
"<The> Bouviers : portrait of an American Family with 32 pages of Photographs.-- Farrar, 1969"	Davis	 John Hagy
"<The> Bouviers : portrait of an American Family with 32 pages of Photographs.-- Farrar, 1969"	s/a	
"<The> boy travellers in South America; adventures of two youths in a journey through.-- Harper and Brothers, 1885"	Knox	 Thomas W.
"<The> Break-up the Habsburg Empire 1914-1918 : a estudy in national.-- Oxford University Press, 1961"	Zeman	 Z   A   B
"<The> Broken commandment.-- Japan Foundation, 1974"	Tosen	 Shimazaki
"<The> buccaneers of America.-- Swan Sonnenschein, 1910"	Esquemeling	 John
"<The> building of cultures.-- C. Scribner's sons, 1928"	Dixon	 Roland Burrage
"<The> buried treasure of archaeology.-- Random House, 1964"	Brennan	 Louis A.
"<The> Byzantine Empire.-- Oxford University Press, 1962"	Baynes	 Norman Hepburn
"<The> Calculation of atomic structures.-- John Wiley, 1957"	Hartree	 Douglas Rayner
"<The> Calculus, with analytic geometry.-- 3a. ed.-- Harper and Row, 1976"	Leithold	 Louis
"<The> Calculus, with analytic geometry.-- 3a. ed.-- Harper and Row, 1976"	s/a	
"<The> Calculus, with analytic geometry.-- 3a. ed.-- Harper and Row, 1976"	s/a	
"<The> Canadian manager : effectiveness in action.-- John Wiley and Sons, 1980"	Bilyea	 Cliff G.
"<The> Capital budgeting decision : economic analysis of inveetment projects.-- 5th. ed.-- MacMillan, 1980"	Bierman	 Harold
"<The> capitals of Spanish America.-- Harper and brothers, 1888"	Curtis	 William Eleroy
"<The> caracol at Chichen Itza, Yucatan, Mexico.-- Carnegie Institution of Washington, 1935"	Ruppert	 Karl
"<The> Care and bireeding of laboratory animals.-- J.Wiley, 1967"	Fannis	 Edmond J.
"<The> Carnivorous plants.-- Chronica Botanica, 1942"	Lloyd	 Francis Ernest
"<The> caste war or Yucatan.-- Stanford University Press, 1964"	Reed	 Nelson
"<The> Cell : chemistry and function.-- C. V. Mosby, 1966"	Trumbore	 Roger H.
"<The> Cell.-- Academic Press, 1959"	Brachet	 J.
"<The> Cell.-- Academic Press, 1959"	s/a	
"<The> Cell.-- Academic Press, 1959"	s/a	
"<The> Cell.-- Academic Press, 1959"	s/a	
"<The> Cell.-- Academic Press, 1959"	s/a	
"<The> Cell.-- Academic Press, 1959"	s/a	
"<The> Cell.-- Time, 1964"	Pfeiffer	 John
"<The> cenotes of Yucatan; a zoological and hydrographic survey.-- Carnegie institution of Washington, 1936"	Pearse	 Arthur Sperry
"<The> Centennial history of the civil war.-- Book of the Month Club, 1965"	Catton	 Bruce
"<The> Central Americans : adventures and impressions between Mexico and Panama.-- C. Scribner's sons, 1928"	Ruhl	 Arthur Brown
"<The> central americans; adventures and impressions between Mexico and Panama.-- C. Scribner's sons, 1928"	Ruhl	 Arthur Brown
"<The> circular, aquare, and octagonal earthworks of Ohio.-- Govt. print. off., 1889"	Thomas	 Cyrus
"<The> Citology of the protein synthesis in an animal cell.-- Gordon and Breach, 1965"	Kedrovskii	 B. V.
"<The> City is our farm : Seven migrant ijebu Yoruba families.-- Schenkman Books, 1980"	Aronson	 Dan R.
"<The> civilization of ancient Mexico.-- University Press, G.P. Putnam's sons, 1912"	Spence	 Lewis
"<The> civilization of the mayas.-- 5 ed..-- Natural History Museum Press, 1953"	Thompson	 John Eric Sidney
"<The> Classical theory of fields (cource of theoretical physics ; v. 2.-- 4a. ed. rev.-- Pergamon Press, 1985"	Landau	 Lev Davidovich
"<The> Classical theory of fields.-- 2a ed..-- Pergamon, 1962"	Landau. Lew Davidovich	-1908
"<The> Classical theory of fields.-- Addison-Wesley Press, 1951"	Landau	 L.
"<The> climatic factor as illustrated in arid America.-- Carnegie institution of Washington, 1914"	Huntington	 Ellsworth
"<The> Clinic : a novel.-- Coward-McCann, 1968"	Kerr	 James
"<The> Colorado river region and John Wessley Powel.-- U.S. Govt. Print. Off., 1969"	s/a	
"<The> columbian tradition on the discovery of America and of the part played therein by the astronomer Toscanelli; a memoir addressed to the professors Hermann Wagner of the University of Gottingen and Carlo Errara of Bologna.-- The Clarendon press, 1920"	Vignaud	 Henry
"<The> Collapse of the third Republic : an inquirity into the fal of france in 1940.-- Simon and Schuster, 1969"	Shirer	 William Lawrence
"<The> Collapse of the third Republic : an inquirity into the fal of france in 1940.-- Simon and Schuster, 1969"	s/a	
"<The> Comedians.-- Viking Press, 1966"	Greens	 Graham
"<The> Comedians.-- Viking Press, 1966"	s/a	
"<The> Common sense of the exact sciences.-- Dover, 1955"	Clifford	 William Kingdon
"<The> Compleat strategyst : being a primer on the theory of games of strategy.-- McGraw-Hill Book Company, 1954"	Williams	 John Davis
"<The> Complete scanner handbook for desktop publishing, Macintosh edition.-- Business One Irwin, 1991"	Busch	 David D.
"<The> Complete scanner handbook for desktop publishing, Macintosh edition.-- Business One Irwin, 1991"	s/a	
"<The> Complete scanner handbook for desktop publishing, Macintosh edition.-- Business One Irwin, 1991"	s/a	
"<The> Complete scanner handbook for desktop publishing, Macintosh edition.-- Business One Irwin, 1991"	s/a	
"<The> complete stylist and handbook.-- 2d. ed.-- Harper and Row, 1980"	Baker	 Sheridan
"<The> complete stylist and handbook.-- 2d. ed.-- Harper and Row, 1980"	s/a	
"<The> Complete works of William Shakespeare, arranged in their chronological order.-- Nelson Doubleday, s.f."	Shakespeare	 William
"<The> Complex j-plane : complex angular momentum in nonrelativistic quantum scatterimg theory.-- W. A. Benjamin, 1964"	Newton	 Riger G.
"<The> condor and the cows, a South American travel diary.-- Random House, 1949"	Isherwood	 Christopher
"<The> Confesions of Nat Turner.-- Randon House, 1967"	Styron	 William
"<The> Congo since independence : january 1960-december 1961. Issued under the auspices of the Royal Institute of International Affairs.-- Oxford University Press, 1965"	Hoskyns	 Catherine
"<The> Conquerors of Perú. Retold from Prescott's ""Conquest of Perú"".-- Thomas Y. Crowell, s.f."	Gilbert	 Henry
"<The> conquest and colonization of Honduras, 1502-1550.-- Octagon Books, 1966"	Chamberlain	 Robert Stoner
"<The> conquest and colonization of Yucatan, 1517-1550.-- s.e., 1948"	Chamberlain	 Robert Stoner
"<The> conquest of civilization.-- Harper and brothers, 1926"	Breasted	 James Henry
"<The> conquest of Mexico.-- Henry Holt and Co., 1922"	Prescott	 William Hickling
"<The> conquest of Mexico.-- Henry Holt and Co., 1922"	s/a	
"<The> conquest of the maya.-- Jarrolds, 1934"	Mitchell	 J. Leslie
"<The> Conquest of Weast India.-- University Microfilms, 1966"	Gómara	 Francisco López de
"<The> conquest of Yucatan.-- Houghton Mifflin company, 1936"	Blom	 Frans Ferdinand
"<The> constant captain, Gonzalo de Sandoval.-- Southern Illinois University Press, 1961"	Gardiner	 Clinton Harvey
"<The> Constitution that delicate balance.-- Random House, 1981"	Friendly	 Fred W.
"<The> contemporary culture of the Cahita indians.-- U.S. Govt. print. off., 1945"	Beals	 Ralph Leon
"<The> Cost of freedom: conversation and modern capitalism.-- Collis Books, 1960"	Wallich	 Henry Christopher
"<The> Covariant classification of two-dimensional smooth commutative formal groups over an algebraically closed field of positive characteristic.-- Mathematisch Centrum, 1983"	Kneppers	 H. A. W. M.
"<The> Cowboys.-- Time-Life Books, 1973"	Forbis	 William H.
"<The> cruise of the cachalot.-- Smith Elder and Co., 1903"	Bullen	 Frank Thomas
"<The> Cultivation of animal and plant cells.-- Ronald Press, 1963"	White	 P. R.
"<The> culture historical method of ethnology; the scientific approach to the racial question.-- Fortuny's, c1939"	Schmidt	 Wilheim
"<The> curious lore of precious stones; being a description of their sentiments and folk lore, superstitions, symbolism, mysticism, use in medicine, protection, prevention, religion, and divination, crystal gazing, birthstones, lucky stones and talismans, astral, zodical and planetary.-- Halcyon house, 1938"	Kunz	 George Frederick
"<The> Cycle of American literature : an essay in historical criticism.-- Macmillan, 1955"	Spiller	 Robert Ernest
"<The> Changing earth: an introduction to geology.-- McGraw-Hill Ryerson, 1977"	Milligan	 George C.
"<The> changing physical environment of the hopi indians of Arizona. Reports of the Awatovi expedition, Peabody museum, Harvard University. Report No. 1.-- Peabody Museum, 1942"	Hack	 John T.
"<The> character of races as influenced by physical environment, natural selection and historical development.-- C. Scribner's sons, 1924"	Huntington	 Ellsworth
"<The> Chemical bond.-- Houghton Mifflin, 1966"	Lagowski	 J.J.
"<The> Chemical statics and kinetics of solutions.-- Academic Press, 1971"	Moelwyn Hughes	 E.A.
"<The> Children of Sánchez: autobiography of a mexican family.-- Vintage Books, 1961"	Lewis	 Oscar
"<The> children, of mu.-- I. Washburn, 1933"	Churchward	 James
"<The> chinese collections of the university museum; a handbook of the principal objects.-- The University museum, University of Pennsylvania, 1941"	Pennsylvania. University. University museum	
"<The> chorti indians of Guatemala.-- The University of Chicago Press, 1940"	Wisdom	 Charles
"<The> Chrysanthemun and the sword : patterns of Japanese culture.-- Houghton, 1946"	Benedict	 Ruth
"<The> Dance language and orientation of bees.-- Harvard University Press, 1967"	Frisch	 Karl Von
"<The> dawn of european civilization.-- New (5th) ed. rev..-- Knopf, 1951"	Childe	 Vere Gordon
"<The> Day Kennedy was shot.-- Fink and Wagnalls, 1968"	Bishop	 Jim
"<The> days of Ofelia.-- Houghton Mifflin company, 1942"	Diamant	 Gertrude
"<The> de la Cruz Badiano Aztec herbal of 1552.-- Maya Society, 1939"	Cruz	 Martín de la
"<The> death committee.-- McGraw-Hill, 1969"	Gordon	 Noah
"<The> descent of man and selection in relation to sex.-- 2a. ed. rev. y augm..-- D. Appleton and company, 1909"	Darwin	 Charles Robert
"<The> Desing of the small public library.-- Bowker, 1966"	Myller	 Rolf
"<The> Desing of the small public library.-- Bowker, 1966"	s/a	
"<The> Determination of molecular structure.-- Clarendon Press, 1968"	Wheatley P.J.	
"<The> Determination of stability constants and other equilibrium constants in solution.-- McGraw-Hill, 1961"	Rossotti	 Francis J.C.
"<The> Development of the infant and young child normal and abnormal.-- 2a. ed.-- E. and S. Livingstone, 1963"	Illingworth	 Rovald Stanley
"<The> diffusion of culture.-- Watts, 1933"	Smith	 G. Elliot
"<The> Digital logic hondbook: flip chip modules.-- [s.n.], 1969"	Digital Equipment Corporation	
"<The> disaster of Darien; the story of the Scots settlement and the causes of its failture, 1699-1701.-- Houghton Mifflin company, 1929"	Hart	 Francis Russell
"<The> Discoveries of John Ledererl.-- University Microfilms, 1966"	Lederer	 John
"<The> discovery and conquest of Mexico, 1517-1521.-- Farrar, Strauss and Cudahy, c1956"	Díaz del Castillo	 Bernal
"<The> Discovery and settlement of Kentucke.-- University Microfilms, 1966"	Filson	 John
"<The> Discovery of New Brittaine.-- University Microfilms, 1966"	Bland	 Edward
"<The> discovery of New Spain in 1518.-- The Cortes Society, 1942"	Grijalva	 Juan de
"<The> discovery of the amazon according to the account of Friar Gaspar de Carvajal and other documents.-- American Geographical Society, 1934"	Carvajal	 Gaspar de
"<The> discovery of Yucatán.-- The Cortes Society, 1942"	Hernández de Córdoba	 Francisco
"<The> Divisor class group of a krull domain.-- Springer-Verlag, 1973"	Fossum	 Robert M.
"<The> doctrina breve, in fac-simile; to which are added ""The Earliest Books in the new world"".-- The United States Catholic Historical Society, 1928"	Zumarraga	 Juan
"<The> Doubleday pictorial library of growth of ideas : knowledge, thought, imagination.-- Doubleday, 1966"	s/a	
"<The> Dress of words : essays on restoration and eighteenth century literature in honor of Richmond P. Bond.-- University of Kansas Libraries, 1978"	White	 Robert B.
"<The> Dress of words : essays on restoration and eighteenth century literature in honor of Richmond P. Bond.-- University of Kansas Libraries, 1978"	s/a	
"<The> Dynamic of automatic control systems.-- Addison-Wesley, 1962"	Popov	 E.P.
"<The> eagle, the jaguar and the serpent; Indian art of the Americas; North America: Alaska, Canada, the United States.-- 1st. ed..-- Knopf, 1954"	Covarrubias	 Miguel
"<The> Early life of stephen hind.-- Harper, 1966"	Jameson	 Margaret Storm
"<The> earth and man, a human geography.-- The Macmillan company, 1942"	Davis	 Darrell Haug
"<The> east and west indian mirror.-- s.e., 1906"	Spilbergen	 Joris van
"<The> Ecology man: an ecosystem approach.-- Harper and Row, 1972"	s/a	
"<The> Ecology of fishes.-- Academic Press, 1963"	Nikolsky	 G. V.
"<The> economic literature of Latin America, a tentative bibliography, compiled by the staff of the Bureau for economic research in Latin America, Harvard University.-- Harvard University Press, 1935-"	Harvard University. Bureau for economic research in Latin America	
"<The> economic literature of Latin America, a tentative bibliography, compiled by the staff of the Bureau for economic research in Latin America, Harvard University.-- Harvard University Press, 1935-"	s/a	
"<The> Economics of the credit inon.-- WAyne State University Press, 1963"	Croteau	 John T.
"<The> Economics of work Japan.-- LTCB Internacional Library Foundation, 1995"	Kazuo	 Koike
"<The> Economy of nature, a textbook in basic ecology.-- Chiron Press, 1976"	Ricklefs	 Robert E.
"<The> Edge of objetivity: an essay in the history of scientific ideas.-- University press, 1966"	Gillispie	 Charles Couleton
"<The> Educational imagination.-- MacMillan, 1979"	Eisner	 Elliot W.
"<The> Eighth day.-- Harper, 1967"	Wilder	 Thornton
"<The> ejido; Mexico's way out.-- The University of North Carolina press, 1937"	Simpson	 Eyler Newton
"<The> Electrochemistry of semiconductor.-- Academic Press, 1962"	Holmes	 P.J.
"<The> Elements of non-euclidean geometry.-- Dover, 1958"	Sommerville	 D. M.
"<The> Emergence of man.-- Harper and Row, 1969"	Pfeiffer	 John E.
"<The> Encyclopedia Americana : the international reference book.-- Americana Corporation, 1963"	s/a	
"<The> Encyclopedia Americana : the international reference book.-- Americana Corporation, 1963"	s/a	
"<The> Encyclopedia Americana : the international reference book.-- Americana Corporation, 1963"	s/a	
"<The> Encyclopedia Americana : the international reference book.-- Americana Corporation, 1963"	s/a	
"<The> Encyclopedia Americana : the international reference book.-- Americana Corporation, 1963"	s/a	
"<The> Encyclopedia Americana : the international reference book.-- Americana Corporation, 1963"	s/a	
"<The> Encyclopedia Americana : the international reference book.-- Americana Corporation, 1963"	s/a	
"<The> Encyclopedia Americana : the international reference book.-- Americana Corporation, 1963"	s/a	
"<The> Encyclopedia of microscopy.-- Reinhold Publishing, 1961"	Clark	 G. L.
"<The> English verb: an exploration of structure and meaning.-- UCA Editores, 1987"	Lewis	 Michael
"<The> English-american, a new survey of the West Indies. 1648.-- G. Routledge and sons, ltd., 1928"	Gage	 Thomas
"<The> Entrepreneur, mainstream views and radical critiques.-- Praeger, 1982"	Gebert	 Robert F.
"<The> Environmental classroom.-- Prentice-Hall, 1973"	Hawkins	 Donald E.
"<The> Epic of the Chaco: Marshal Estigarribia's memoirs of the Chaco war 1932-1935.-- The University of Texas Press, 1950"	Estigarribia	 José Félix
"<The> Essential Lincoln.-- Gollier, 1962"	Stearn	 Gerald Emanuel
"<The> etruscans.-- Penguin Books, 1955"	Pallottino	 Massimo
"<The> European common market; an analysis of commercial policy.-- Frederick A. Praeger, 1961"	Frank	 Isaiah
"<The> Evaluation of therapeutic agents and cosmetics.-- McGraw-Hill, 1964"	Sternberg	 Thomas Hunter		
"<The> Evolution of scientific thought from Newton to Einstein.-- Dover Publications, 1950"	s/a			
"<The> Expedition of Lewis and Clark.-- University Microfilms, 1966"	Lewis	 Meriwether		
"<The> Expedition of Lewis and Clark.-- University Microfilms, 1966"	Clark	 William	 Nicholas	 1786-1844
"<The> Experimental basis of modern biology.-- University Press, 1966"	Ramsay	 James Arthur		
"<The> Explorer.-- McGraw-Hill, 1964"	Keyes	 Frances Parkinson		
"<The> Explorer.-- McGraw-Hill, 1964"	s/a			
"<The> face of South America, an aerial traverse.-- American Geographical Society, 1942"	Rich	 John Lyon		
"<The> Fellowship of the ring.-- Ballantine Books, 1969"	Tolkien	 John Ronald Revel		
"<The> Fellowship of the ring.-- Ballantine Books, 1969"	s/a			
"<The> Fellowship of the ring.-- Ballantine Books, 1969"	s/a			
"<The> Ferocious engine of democracy : a history of the American Presidency.-- Madison Books, 1995"	Riccards	 Michael P.		
"<The> Fetal pig.-- Burgess Publishing, 1963"	Holstad	 G.E.		
"<The> Feynman lectures on physics.-- Addison-Wesley, 1963"	Feynman	 Richard Phillips		
"<The> Feynman lectures on physics.-- Addison-Wesley, 1963"	Leighton	 Robert B.		
"<The> first comers; indians of America's dawn.-- 1st. ed..-- Longmans, Green, 1960"	Marriott	 Alice Lee		
"<The> First day of friday.-- Random House, 1963"	Tracy	 Haner
"<The> First day of friday.-- Random House, 1963"	s/a	
"<The> First social experiments in America. A study in the development of Spanish Indian policy in the sixteenth century.-- Harvard University, 1935"	Hanke	 Lewis
"<The> Firts circle.-- Harper and Row, 1968"	Solzhenitsyn	 Aleksander Iseavich
"<The> Fishes of Alberta.-- Government of Alberta, 1970"	Paetz	 Martin J.
"<The> Fishes.-- Time Incorporated, 1964"	Ommanney	 F. D.
"<The> Fixer.-- Farrar Straus and Giroux, 1966"	Malamud	 Bernard
"<The> Flora of a changing britain. Hampton, Middlesex.-- Botanical Society of the British Isles, 1970"	Perring	 Franklin Hugh
"<The> flowing road; adventuring on the great rivers of South America.-- J.B. Lippincott company, 1912"	Whitney	 Caspar
"<The> folk culture of Yucatan.-- University of Chicago Press, 1964"	Redfield	 Robert
"<The> Forest and the sea : a look at the economy of nature and the ecology of man.-- Time Life Books, 1980"	Bates	 Marston
"<The> formative years of the Missionary College of Santa Cruz of Querétaro, 1683-1733.-- Catholic University of America Press, 1955"	McCloskey	 Michael Brendan
"<The> Founding father.-- New American Library, 1964"	Whalen	 Richard J.
"<The> French : portrait of a people.-- Putnam's, 1969"	Gramont	 Sanche de
"<The> French lievtenant's woman.-- Little Brown, 1969"	Fowles	 John
"<The> French lievtenant's woman.-- Little Brown, 1969"	s/a	
"<The> French Revolution.-- Oxford University Press, 1966"	Belloc	 Hilaire
"<The> Fresh-water algae of the United States.-- 2th. ed.-- McGraw-Hill, 1950"	Smith	 Gilbert M.
"<The> fundamental constants of physics.-- Interscience, 1957"	Cohen	 E. Richard
"<The> Fundamental particles.-- Addison-Wesley, 1965"	Swartz	 Clifford E.
"<The> future of Latin American exports to the United States: 1965 and 1970.-- National Planning Association, 1960"	Delwart	 Louis O.
"<The> Games.-- Simon and Schuster, 1968"	Atkinson	 Hugh
"<The> Genera of flowering plants (angiospermas).-- Clarendon Press, 1964-67"	Hutchinson	 J.
"<The> Genetics of colonizing species : proceedings.-- Academic Press, 1965"	International Union of Biological Sciences Symposia on General Biology	
"<The> Genetics of tribolium and related species.-- Academic Press, 1966"	Sokoloff	 Alexander
"<The> Gentleman from California.-- Simon and Schuster, 1965"	Busch	 Niven
"<The> geographical, natural and civil history of Chili.-- ?, 1809"	Molina	 Juan Ignacio
"<The> geological evidence of the antiquity of man.-- George W. Childs, 1863"	Lyell	 Sir Charles
"<The> gods of Mexico.-- T.F. Unwin, ltd., 1923"	Spence	 Lewis
"<The> gods were kind; an epic 6700 mile voyage alone across the pacific.-- 1st. ed..-- Dutton, 1955"	Willis	 William
"<The> Golden age of American anthropology.-- George Braziller, 1960"	Mead	 Margaret
"<The> Goldfish.-- Batchworth, 1948"	Hervey	 G. F.
"<The> Good Life.-- Atheneum, 1968"	Wallop	 Douglass
"<The> Government of the Rhine Palatinate in the fifteenth century.-- Oxford University Press, 1965"	Cohn	 Henry J
"<The> Grand coule.-- American geographical society, 1932"	Bretz	 J. Harlen
"<The> Grasses of Burma, Ceylon, India and Pakistan.-- Pergamon Press, 1960"	Bor	 N. L.
"<The> Grasslands of Latin America..-- Imperial Bureau of Pastures and Field Crops, 1948"	Roseveare	 G. M.
"<The> Great chiefs.-- Time-Life Books, 1975"	Capps	 Benjamin
"<The> Great esperiment.-- New American Library, 1963"	Thistlethwaite	 Frank
"<The> Great experiment in american literature : six lectures.-- Heinemann, 1961"	Bode	 Carl
"<The> great idol of Tiahuanaco; an interpretation in the light of the Hoerbiger theory of satellites of the glyphs carved on its surface.-- Faber and Faber, 1959"	Bellamy	 Hans Schindler
"<The> great kivas of Chaco Canyon and their relationships.-- School of American Research, 1960"	Vivian	 R. Gordon
"<The> great white gods, an epic of the Spanish invasion of Mexico and the conquest of the barbaric aztec culture of the new world.-- Farrar and Rinehart, inc., c1934"	Stucken	 Eduard
"<The> greatest book in the world, and other papers.-- Little Brown, c1925"	Newton	 Alfred Edward
"<The> Green frontier.-- Fawcett Publications, 1969"	McMillen	 Wheeler
"<The> green world of the naturalists; a treasury of....-- Greenberg, 1948"	Von Hagen	 Victor Wofgang
"<The> guajxaquíp báts, an indian ceremony of Guatemala.-- s.e., 1937"	Goubaud	 Antonio
"<The> guanches of Tenerife.-- s.e., 1907"	Espinosa	 Alonso de
"<The> Hall of fame for Great Americans oficial.-- N. York University Press, 1962"	Morello	 Theodore
"<The> Hapsburg monarchy 1867-1914.-- Harvard University Press, 1965"	May	 Arthur J.
"<The> heart of the forest.-- [1st American ed.].-- Knopf, 1961"	Cowell	 Adrian
"<The> Higher terpenoids.-- Interscience, 1959"	Mayo	 Paul de
"<The> hill-caves of Yucatan; a search for evidence of man's antiquity in the caverns of Central America.-- J.B. Lippincott, 1896"	Mercer	 Henry C.
"<The> hispanic acculturation of the Gila River Pimas.-- American Anthropological Association, 1961"	Ezell	 Paul H.
"<The> History and use of diamond.-- Methuen, 1962"	Tolansky	 Samul
"<The> History of combinatorial group theory: a case study in the history of ideas.-- Springer-Verlag, 1982"	Chandler	 Bruce
"<The> history of Mexico. Collected from spanish and mexican historians, from manuscripts and ancient paintings of the indians.-- G.G.J. and J. Robinson, 1787"	s/a	
"<The> history of Mexico. Collected from spanish and mexican historians, from manuscripts and ancient paintings of the indians.-- G.G.J. and J. Robinson, 1787"	Clavijero	 Francisco Javier
"<The> history of science and the new humanism.-- Harvard university press, 1937"	Sarton	 George
"<The> History of South America frommits discovery to the present time.-- Swan Sonnenschein and Co., 1899"	s/a	
"<The> history of the maya from the earliest times to the present day.-- C. Scribner's sons, 1931"	Gann	 Thomas William Francis
"<The> history of Yucatan from its discovery to the close of the seventeenth century.-- John Murray, albemarle Street, 1854"	Fancourt	 Charles St. John
"<The> Hon. rocky slade.-- Little, Brown, 1957"	Haines	 William Wister
"<The> horse in blackfoot indian culture, with comparative material from other western tribes.-- U.S. Govt. Print. off., 1955"	Ewers	 John Canfield
"<The> house in Antigua; a restoration.-- 1a. ed..-- Harper and brothers, 1937"	Adamic	 Louis
"<The> House on the strand.-- Doubleday, 1969"	Du Maurier	 Daphne
"<The> Human factor in changing Africa.-- Alfred A. Knopf, 1962"	Herskovits	 Melville Jean
"<The> Human landscape: geography and culture.-- Charles E. Merril, 1983"	Zimolzak	 Chester E.
"<The> Human nervous system : an anatomical viewpoint.-- Harper and Row, 1972"	Barr	 Murray L.
"<The> Human organization : its management and value.-- McGraw-Hill, 1967"	Likert	 Rensis
"<The> Human revolution.-- Weatherhill, 1972"	Ikeda	 Daisaku
"<The> Human revolution.-- Weatherhill, 1972"	s/a	
"<The> Human revolution.-- Weatherhill, 1972"	s/a	
"<The> Human zoo.-- McGraw-Hill, 1969"	Morris	 Desmond
"<The> Hungarian revolution : the story of the october uprising as recorded in documents dispatches, eye-withess accounts, and worldwide reactions.-- Frederick A. Praeger, 1957"	Lasky	 Melvin J.  ed.
"<The> Hungarian revolution.-- Deutsch, 1957"	Mikes	 George
"<The> Hurricane years.-- Little, Brown, 1968"	Hawley	 Cameron
"<The> Hydrogen Bond.-- Freeman, 1960"	Pimentel	 George C.
"<The> Idea of history.-- Oxford University Press, 1963"	Collingwood	 R. G.
"<The> Ideologies of developing nations.-- Frederick A. Praeger, 1963"	Sigmund	 Paul E.
"<The> imagination of primitive man. A survey of the arts of the nonliterate peoples of the world.-- University Trustees, s.f."	Kansas City. The Nelson Gallery	
"<The> immense journey.-- Random House, 1957"	Eiseley	 Loren C.
"<The> Impirtance of antibonding orbitals.-- Houhton Mifflin, 1967"	Orchin	 Milton
"<The> incredible yanki; the career of Lee Christmas.-- Longmans, Green and co., 1931"	Deutsch	 Hermann Bacher
"<The> indian and antiquities of America.-- Sherman and co., printers, 1897"	Shipp	 Barnard
"<The> indian background of colonial Yucatan.-- s.e., 1943"	Roys	 Ralph Loveland
"<The> indian tribes of North America.-- Smithsonian Institution Press, 1969"	Swanton	 John Reed
"<The> Indians of Panama; their history and culture.-- Printed by the Panama American Publishing company, 1944"	Humphries	 Frank Theodore
"<The> indians of the Americas.-- 1st. ed..-- W.W. Norton, 1947"	Collier	 John
"<The> Indians of the western Great lakes, 1615-1760.-- University of  Michigan press, 1940"	Kinietz	 William Vernon
"<The> indians of Tierra del Fuego.-- Museum of the American Indian, Heye Foundation, 1928"	Lothrop	 Samuel Kirkland
"<The> indians of today.-- H.S. Stone and company, 1900"	Grinnell	 George Bird
"<The> influence of technique on the decorative style in the domestic pottery of Culhuacán.-- Columbia University Press, 1931"	Brenner	 Anita
"<The> inscriptions of Peten.-- Carnegie Institution of Washington, 1938"	Morley	 Sylvanus Griswold
"<The> inscriptions of Peten.-- Carnegie Institution of Washington, 1938"	s/a	
"<The> inscriptions of Peten.-- Carnegie Institution of Washington, 1938"	s/a	
"<The> inscriptions of Peten.-- Carnegie Institution of Washington, 1938"	s/a	
"<The> inscriptions of Peten.-- Carnegie Institution of Washington, 1938"	s/a	
"<The> inscriptions of Peten.-- Carnegie Institution of Washington, 1938"	s/a	
"<The> interpretation of proton magnetic resonance spectra : a programmed introduction.-- Heyden, 1973"	Haws	 Edmond John
"<The> Interpretation of ultrastructure.-- 2th. ed.-- Academic Press, 1962"	Harris	 Robert John Cecil
"<The> Invertebrates.-- McGraw-Hill, 1940"	Hyman	 Libbie Henrietta
"<The> Invertebrates.-- McGraw-Hill, 1940"	s/a	
"<The> Invertebrates.-- McGraw-Hill, 1940"	s/a	
"<The> Invertebrates.-- McGraw-Hill, 1940"	s/a	
"<The> Irish countruman: an anthropological study.-- Peter Smith, 1959"	Arensberg	 Conrad Maynadier
"<The> iroquois eagle dance; an offshoot of the Clumet dance with an analysis of the Iroquois eagle dance and songs.-- U.S. Govt. Print. Off., 1953"	Fenton	 William Nelson
"<The> islands of Titicaca and Kosti.-- The Hispanic society of America, 1910"	Bandelier	 Adolph Francis Alphonse
"<The> Isthmus of Panamá.-- Chapman and Hall, 1865"	Bidwell	 Chalres Toll
"<The> jaguar's children: pre-classic central Mexico.-- Museum of Primitive Art; distributed by the New York Graphic Society, Greenwich Conn., 1965"	Coe	 Michael D.
"<The> japanese market economy system : its strengths and weaknesses.-- LTCB International Library Fundation, 1996"	Tsuru Kotaro	
"<The> journal of an expedition across Venezuela and Colombia, 1906-1907 ; an exploration of the route of Boliva's celebrated march of 1819 and of the battle-fields of Boyacá and Carabobo.-- Yale publishing association; etc., etc., 1909"	Bingham	 Hiram
"<The> Journey of coronado.-- Universty Microfilms, 1966"	Winship	 George Parker
"<The> journey of the flame, being an one year in....-- Printed by the Riverside press for Houghton Mifflin company, 1933"	Nordhoff	 Walter
"<The> Kennedy family.-- Little Brown and Co., 1959"	Dinneen	 Joseph Francis
"<The> Kinetic theory of gases : being a tex and reference book whose purpose is to combine the classical deductions with recent experimental advances in a convenient form student and investigator.-- 3. ed.-- Dover, 1961"	Loeb	 Leonard Benedict
"<The> kingdom of the ""White woman""; a sketch.-- R. Clarke and co., 1894"	Shoemaker	 Michael Myers
"<The> Kingdon of Jordan.-- University Press, 1958"	Patai	 Raphael
"<The> Kissing Man.-- The Macmillan Co., 1962"	Elliott	 George
"<The> Kissing Man.-- The Macmillan Co., 1962"	s/a	
"<The> Kissing Man.-- The Macmillan Co., 1962"	s/a	
"<The> Kissing Man.-- The Macmillan Co., 1962"	s/a	
"<The> land beyond Mexico.-- R. G. Badger, c1920"	Carpenter	 Rhys
"<The> Land breakers.-- Harper and Row, Publishers, 1964"	Ehle	 John
"<The> Land breakers.-- Harper and Row, Publishers, 1964"	s/a	
"<The> land of the pheasant and the deer, folksong of the maya.-- Editorial Cultura, 1935"	Mediz Bolio	 Antonio
"<The> land systems of Mexico.-- American Geographical Society, 1923"	McBride	 George McCurchen
"<The> Language and thought of the child.-- 3a. ed.-- Routledge and Kegan Paul, 1959"	Piaget	 Jean
"<The> Language encounter in the Americas, 1492-1800 : a collection  of essays.-- Berghahn Books, 2000"	s/a	
"<The> language of argument.-- Harper and Row, 1980"	McDonald	 Daniel Lamont
"<The> Language of life : an introduction to the science of genetics.-- Doubleday, 1966"	Beadle	 George
"<The> language of the Papago of Arizona.-- University Museum, University of Pennsylvania, 1950"	Mason	 John Alden
"<The> Last hurrah.-- Little, Brown Company, 1956"	O'Connor	 Edwin
"<The> Last hurrah.-- Little, Brown Company, 1956"	s/a	
"<The> last of the Seris.-- E.P. Dutton and co., inc., c1939"	Coolidge	 Dane
"<The> last titan : Percival Farguhar, American entrepreneur in Latin America.-- Institute of International, 1972"	Gauld	 Charles A.
"<The> Last voyage perform'd by de la Sale.-- University Microfilms, 1966"	Joutel	 Henri
"<The> latin image in American film.-- University of California, 1977"	Woll	 Allen L.
"<The> legacy of Greece.-- The Clarendon Press, 1922"	Livingstone	 Sir Richard Winn
"<The> Legacy of Persia.-- Clarendon Press, 1963"	Arberry	 Arthur John
"<The> Legancy of Egypto.-- Clarendon Press, 1963"	Glanville	 Stephen Ranulph Kingdon
"<The> Legend of the seventh Virgin.-- Doubleday, 1964"	Holt	 Victoria
"<The> Life and death of Lenin.-- Simon and Schuster, 1964"	Payne	 Pierre Stephen
"<The> Life and death of Lenin.-- Simon and Schuster, 1964"	s/a	
"<The> life and voyages of Christopher Columbus, to which are added those of his companions.-- G.P. Putnam's sons, 1902"	Irving	 Washington
"<The> Life and writings de Abraham Lincoln.-- The Modern Library, 1940"	Stern	 Philip Van Doren
"<The> Life of birds.-- s.e., 1962"	Welty	 Joel Carl
"<The> Life of Joaquín Nabuco.-- University Press, 1950"	Nabuco	 Carolina
"<The> Life of las Casas The apostle of the Indies.-- 2a ed..-- Bell and Daldy, 1868"	Helps	 Sir Arthur
"<The> Life of mammals.-- Universe Books, 1969-71"	Matthews	 Leonard Harrison
"<The> Life of Marquis Shigenobu Okuma : a biographical study in the rise of democratic Japan.-- 2a. ed.-- The Hokuseido, 1956"	Iddittie	 Junesay
"<The> life of Pizarro, with some account of his associayes in the conquest of Peru.-- G. Bell and sonns, 1896"	Helps	 Sir Arthur
"<The> Life of vertebrates.-- 2d. ed.-- Oxford University Press, 1962"	Young	 J. Z.
"<The> Link, a victorian mystery.-- McGraw-Hill, 1969"	Maugham	 Robin
"<The> Link, a victorian mystery.-- McGraw-Hill, 1969"	s/a	
"<The> lipchitz (Jacques, Yulla and Lolya) collection; catalogue of the exhibition.-- Distributed by University Publishers, 1960"	New York. Museum of Primitive Art	
"<The> Lipids : their chemistry and biochemistry.-- Interscience, 1951"	Deuel	 Harry James
"<The> Lipids : their chemistry and biochemistry.-- Interscience, 1951"	s/a	
"<The> Lives of Vasco Nuñez de Balboa, the discoverer of the pacific ocean, Hernando Cortes, the conqueror of mexico, and Francisco Pizarro, the conqueror of Peru.-- W.M. Grosby and H. P. Nichols, 1840"	s/a	
"<The> Living cell.-- W. H. Freeman, 1965"	Scientific American	
"<The> Living clocks.-- Collins, 1972"	Ward	 Ritchie R.
"<The> Living sea.-- Harper and Row, 1963"	Cousteau	 Jacques Yves
"<The> lKung San : men, women and work in a foreging society.-- Cambridge University Press, 1979"	Lee	 Richard Borshey
"<The> Logic of modern physics.-- Macmillan, 1961"	Bridgman	 Percy Williams
"<The> Lonely sickness.-- Beacon Press, 1965"	Whitney	 Elizabeth D.
"<The> looting of Nicaragua.-- Arno Press, 1970, c1928"	Nogales y Méndez	 Rafael de
"<The> Lost city.-- Harper and Row, 1964"	Gunther	 John
"<The> lost continent of mu.-- I. Washburn, 1931"	Churchward	 James
"<The> lost empires of the itzaes and mayas; an American civilization, contemporary with christ, which rivaled the culture of Egypt.-- The Arthur H. Clark company, 1933"	Willard	 Theodore Arthur
"<The> Lost Queen.-- Doubleday, 1968"	Lofts	 Norak
"<The> lost world of Quintana Roo.-- 1st. ed..-- Dutton, 1963"	Peissel	 Michel
"<The> Lloyd William Taylor manual of advanced undergraduate experiments in physics.-- Addison-Wesley, 1959"	Brown	 Thomas Benjamin
"<The> Lloyd William Taylor manual of advanced undergraduate experiments in physics.-- Addison-Wesley, 1959"	s/a	
"<The> Machinery of life.-- McGraw-Hill, 1966"	Wooldridge	 Dean E.
"<The> Madstone.-- J. B. Lippincott, 1958"	Faralla	 Dana
"<The> magic land of the maya.-- G. Allen and Unwin ltd., 1928"	Puxley	 W. Lavallin
"<The> Magneto-ionic theory and ite applications to the inosphere : a monograph.-- University Press, 1962"	Ratcliffe	 John Ashworth
"<The> Mague.-- Little Brown, 1966"	Fowles	 John
"<The> Mainstream of physics.-- Addison-Wesley, 1962"	Beiser	 Arthur
"<the> Makers of Taiwan.-- China Publishing company, [19..]"	Goddard	 William G.
"<The> Making of american history.-- Holt, Rinehart and Winston, 1963"	Sheehan	 Donald Henry
"<The> Making of an american.-- The Macmillan Company, 1964"	Riis	 Jacob A.
"<The> Making of modern America.-- Hougton Mifflin, 1958"	Canfield	 Leon Hardy
"<The> Making of modern Malaya : a history from earliest times to independence.-- 2 ed.-- Oxford University Press, 1965"	Ryan	 N. J.
"<The> Making of modern man. From the renaissance to the present.-- D. Van Nostrand, 1968"	Snyder	 Louis L.
"<The> making of statistician.-- Springer-Verlag, 1982"	Gani	 J.
"<The> Maley archipielago.-- Dover Publications, 1962"	Wallace	 Alfred Russel
"<The> Man who knew Kennedy.-- The Dial Press, 1967"	Bourjaily	 Vance
"<The> man who likes Mexico; the spirited chronicle of adventurous wanderings in mexican highways and byways.-- The Century co., 1911"	Gillpatrick	 Owen Wallace
"<The> Management of scientist.-- Beacon Press, 1964"	Hill	 Karl
"<The> Management of scientist.-- Beacon Press, 1964"	s/a	
"<The> Management of wild mammals in captivity.-- The University of Chicago Press, 1964"	Crandall	 Lee Saunders
"<The> Marine algas of Jamaica.-- The Institute of Jamaica, 1961"	Chapman	 Valentiene Jackson
"<The> Marine algas of Jamaica.-- The Institute of Jamaica, 1961"	s/a	
"<The> Mask of Apollo.-- Pantheon Books, 1966"	Renault	 Mary
"<The> mastering of Mexico; told after one of the conquistadores and various of his interpreters.-- The MacMillan Co., 1916"	Stephens	 Kate
"<The> Matematical theory of communication.-- University of Illinois Press, 1949"	Shamon	 Claude E.
"<The> Mathematical theory of optimal progress.-- Interscience Publishers, 1963"	Pontryagin	 Lev Semenovich
"<The> Mathematical theory of relativity.-- The University Press, 1960"	Eddington	 Sir Arthur Stanley
"<The> Mathematics of physics and chemistry.-- 2. ed.-- Princeton, 1956"	Margenau	 H.
"<The> maya and their neighbors.-- D. Appleton-Century, 1940"	s/a	
"<The> maya and tzental calendars. Comprising the complete series of days.-- s.e., 1900"	Gates	 William Edmond
"<The> maya civilization.-- Southwest Museum, 1954"	Brainerd	 George W.
"<The> maya chontal indians of Acalan.Tixchel; a contribution to the history and ethnography of the Yucatan Peninsula.-- s.e., 1948"	Scholes	 France Vinton
"<The> maya chronicles.-- D.G. Brinton, 1882"	Brinton	 Daniel Garrison
"<The> maya of east central Quintana Roo.-- s.e., 1945"	Villa Rojas	 Alfonso
"<The> mayas, the sources of their history. Dr. Le Plongeon in Yucatan, his account of discoveries.-- Press of C. Hamilton, 1877"	Salisbury	 Stephen
"<The> Mcdougall collection of indian textiles from Guatemala and Mexico.-- Printed at the University Press, 1948"	Start	 Laura Emily
"<The> McMillan handbook of english.-- 4th ed.-- The MacMillan, 1960"	Kierzek	 John M.
"<The> megalithic monuments of Carnac and Locmariaquer: their purpose and age....-- s.e., 1908"	Le Rouzic	 Zacharie
"<The> Men of Cajamarca: a social and biographical study of the first conquerors of Peru.-- University of Texas Press, 1972"	Lockhart	 James Marvin
"<The> Menorah men.-- Harper and Row, 1966"	Davidson	 Lionel
"<The> merrimack archaeological survey, a preliminary paper.-- Peabody museum, 1931"	Moorehead	 Warren King
"<The> mexican calendar stone.-- Press of C. Hamilton, 1879"	Salisbury	 Stephen
"<The> Mexican claims commissions, 1923-1934; a study in the law and procedure of international tribunals.-- The Macmillan company, 1935"	Feller	 Abraham Howard
"<The> mexican nation, a history.-- The Macmillan, 1926"	Priestley	 Herbert Ingram
"<The> Mexican nobility at independence 1780-1826.-- Institute of Latin American Studies, 1976, 1976"	Ladd	 Doris M.
"<The> mexican people; their struggle for freedom.-- Doubleday Page and co., 1914"	Gutiérrez de Lara	 Lazaro
"<The> mexican problem.-- Houghton Mifflin company, 1947"	Barron	 Clarence Walker
"<The> mexican southland. An account of the author's wanderings upon and of the plants, animals, people, commerce and industries of the istmus of Tehuantepec.-- Benton Review Shop, 1922"	Al-Shimas	 Kamar
"<The> mexican touch.-- Duell Sloan and Pearce, c1940"	Moser	 Mrs. Edwa
"<The> mexican venture; from political to industrial revolution in Mexico.-- Oxford University Press, 1953"	Call	 Tomme Clark
"<The> Microbial world.-- 4th. ed.-- Prentice-Hall, 1963"	Stainer	 Roger Y.
"<The> middle east and North Africa.-- Europa Publications Limited, 1965"	s/a	
"<The> middle east and North Africa.-- Europa Publications Limited, 1965"	s/a	
"<The> Middle East, 1914-1979. Documents of modern history.-- Edward Arnold, 1980"	Fraser	 T. G.
"<The> Might of nations: world politics in our time.-- 4a. ed.-- Random House, 1973"	Stoessinger	 John George
"<The> mikado's empire.-- Harper, 1876"	Griffis	 William Elliot
"<The> miscellaneous dates of the dresden codex.-- s.e., 1957"	Makemson	 Maud (Worcester) 1891-
"<The> modaal personality structure of the Tuscarora Indians as revealed by the Rorschach test.-- U. S. Govt. Print., 1952"	Wallace	 Anthony F. C. 1923-
"<The> modern tradition : an anthology of short stories.-- Little, Brown, 1976"	Howard	 Daniel F.
"<The> Molecular biology of development.-- Clarendon Press, 1965"	Bonner	 James Frederick
"<The> Molecular biology of viruses : proceedings.-- Academic Press, 1967"	Symposium of the molecular biology of viruses	 University of Alberta
"<The> Molecular control of cellular activity.-- McGraw-Hill, 1962"	Allen	 J. M.
"<The> Monarch butterfly.-- University of Toronto Press, 1960"	Urquhart	 F. A.
"<The> monasteries of the Wadi'n Natrun.-- s.e., 1926-33"	Evelyn-White	 Hugh Gerard
"<The> Moonflover couple.-- Doubleday, 1967"	Fairchild	 John
"<The> Morning after: a french journalist's impressions of Cuba under Castro.-- Frederick A. Praeger, 1963"	Franco	 Víctor
"<The> Mössbauer effect : a review, with a collection of reprint.-- W. A. Benjamin, 1963"	Frauenfelder	 Hans
"<The> mound builders: their works and relics.-- Office of the American antiquarian, 1892"	Peet	 Stephen Denison
"<The> Myth of the nogro past.-- Beacon Press, 1964"	Herskovita	 Mellville Jean
"<The> myths of Mexico and Peru.-- George G. Harrap, 1913"	Spence	 Lewis
"<The> myths of Mexico and Peru.-- George G. Harrap, 1913"	s/a	
"<The> myths of the new world; a treatise on the symbolism and mythology of the red race of America.-- 2d. ed. rev..-- H. Holt and company, 1876"	Brinton	 Daniel Garrison
"<The> myths of the new world; a treatise on the symbolism and mythology of the red race of America.-- 2d. ed. rev..-- H. Holt and company, 1876"	s/a	
"<The> nacoochee mound in Georgia.-- Museum of the American Indian, Heye Foundation, 1918"	Heye	 George Gustav
"<The> nanticoke community of Delaware.-- Museum of the American Indian, Heye Foundation, 1915"	Speck	 Frank Gouldsmith
"<The> National period in the history of the new world; an outline and commentary.-- Libros de México, 1961"	Griffin	 Charles C.
"<The> native americans : prehistory and ethmology of the North Americans indians.-- Harper and Row, 1965"	Spencer	 Robert F.
"<The> native calendar of Central America and Mexico, a study in linguistics and simbolism.-- MacCalla, 1893"	Brinton	 Daniel Garrison
"<The> native polity of Ponape.-- Smithsonian Institution Press; for sale by the Supt. of Docs. U.S. Govt. Print. Off., 1968"	Riesenberg	 Saul H.
"<The> native races of the Pacific States of North America.-- D. Appleton, 1875-76"	Bancroft	 Hubert Howe
"<The> native races of the Pacific States of North America.-- D. Appleton, 1875-76"	s/a	
"<The> native races of the Pacific States of North America.-- D. Appleton, 1875-76"	s/a	
"<The> native races of the Pacific States of North America.-- D. Appleton, 1875-76"	s/a	
"<The> native races of the Pacific States of North America.-- D. Appleton, 1875-76"	s/a	
"<The> native religions of Mexico and Peru.-- C. Scribner's sons, 1884"	Reville	 Albert
"<The> Natural history of igneous.-- Hafner, 1965"	Harker	 Alfred
"<The> Natural history of mosquitoes.-- Macmillan, 1949"	Bates	 Marston
"<The> Natural philosophy of plant form.-- University Press, 1950"	Arbor	 Agnes
"<The> NAtural pigments.-- Interscience, 1960"	Bentley	 Kenneth Walter
"<The> naturalist in Nicaragua. A narrative of a residence at the gold mines of Chontales; journeys inb the savannahs and forests; with observations on animals and plants in reference to the theory of evolution of living forms.-- 2a. ed. rev. and cor..-- E. Mumpus, 1888"	Belt	 Thomas
"<The> Nature of culture.-- University of Chicago Press, 1952"	Kroeber	 Alfred Louis
"<The> Nature of natural history.-- Charles Scribner's, 1950"	Bates	 Marston
"<The> Nature of parasitism : The relations-Hip of some metazoan parasites to their hosts.-- Academic Press, 1962"	Roger	 William Percy
"<The> Nature of physical theory.-- Dover Publicatios, 1936"	Bridgman	 P. W.
"<The> Navigator.-- University Microfilms, 1966"	Cramer	 Zadok
"<The> Negro revolution in America.-- Simon and Schuster, 1964"	Brink	 William
"<The> Nest architecture of the sweat bees (Halictinae). A comparative study of behavior.-- University of Kansas Press, 1962"	Sakagami	 Shoichi F.
"<The> Neurochemistry of arthropods.-- University Press, 1966"	Treherne	 J. E.
"<The> New class: analyisi of the communist system.-- Frederik A. Praeger, 1962"	Dilas	 Milovan
"<The> New Encyclopedia britanica.-- Encyclopedia Britanica, 1977"	s/a	
"<The> New Encyclopedia britanica.-- Encyclopedia Britanica, 1977"	s/a	
"<The> New Encyclopedia britanica.-- Encyclopedia Britanica, 1977"	s/a	
"<The> New Encyclopedia britanica.-- Encyclopedia Britanica, 1977"	s/a	
"<The> New Encyclopedia britanica.-- Encyclopedia Britanica, 1977"	s/a	
"<The> New Encyclopedia britanica.-- Encyclopedia Britanica, 1977"	s/a	
"<The> New Encyclopedia britanica.-- Encyclopedia Britanica, 1977"	s/a	
"<The> New Encyclopedia britanica.-- Encyclopedia Britanica, 1977"	s/a	
"<The> new museum of villa Giulia.-- Tipografía Artística, 1957"	Vighi	 Roberto
"<The> New poets of england an America : an anthology.-- Meridian Books, 1957"	Hall	 Donald
"<The> New Webster encyclopedic dictionary of the english language.-- Consolidated Book Publishers, 1977"	s/a	
"<The> News in America.-- HArvard University Press, 1962"	Mott	 Frank Luther
"<The> News media: a journalist looks at his profession.-- Holt, Rinehart and Winston, 1968"	Hohenberg	 John
"<The> Nicaragua canal and the Monroe doctrine; a political history of isthmus transti, with special reference to the Nicaragua canal project and the attitude of the United States government thereto.-- G.P. Putnam's sons, 1896"	Keasbey	 Lindley Miller
"<The> Non-recognition of El Salvador: the failure of a policy.-- Southern Illinois University, 1968"	Schmitz	 martin
"<The> North Americans of antiquity; their origin, migrations and type of civilization considered.-- Harper and brothers, 1880"	Short	 John Thomas
"<The> Northern and central Nootkan tribes.-- U. S. Govt. Print. Off., 1951"	Drucker	 Philip
"<The> Norton anthology of poetry.-- Norton, 1975"	Allison	 Alexander W.
"<The> Norton anthology of poetry.-- Norton, 1975"	s/a	
"<The> Norton anthology of short fiction.-- W. W. Norton, 1978"	Cassil	 Ronald Veolin 1519-
"<The> Norton anthology of short fiction.-- W. W. Norton, 1978"	s/a	
"<The> Norton anthology of short fiction.-- W. W. Norton, 1978"	s/a	
"<The> Norton anthology of short fiction.-- W. W. Norton, 1978"	s/a	
"<The> Norton anthology of short fiction.-- W. W. Norton, 1978"	s/a	
"<The> Norton reader : an anthology of expository prose.-- W. W. Norton, 1980"	Eastman	 Arthur M. 1918-ed
"<The> Norton reader : an anthology of expository prose.-- W. W. Norton, 1980"	s/a	
"<The> Norton reader : an anthology of expository prose.-- W. W. Norton, 1980"	s/a	
"<The> Norton reader : an anthology of expository prose.-- W. W. Norton, 1980"	s/a	
"<The> Norton sampler : short essays for composition.-- W. W. Norton, 1979"	Cooley	 Thomas
"<The> Novels of Pérez Galdos, the concept of life as dynamic process.-- University Studies, 1954"	Eoff	 Shermann Hinkle
"<The> Nuclear energy industry of United Kingdon.-- El autor, 1961"	Gran Bretaña. United Atomic Energy Authority	
"<The> Nuclear years : the arms race and arms control.-- Prager, 1970"	Roberts	 Chalmers M.
"<The> Nuer: a description of the modes of livelihood of a nicotic people.-- Clarendon, 1965"	Evans-Pritcahrd	 Edward Evan
"<The> numeration, calendar systems and astronomical knowledge of the mayas.-- The University Press, 1910"	Bowditch	 Charles Pickering
"<The> Oceans: their physics, chemistry and general biology.-- Prentice-Hill, 1955"	Sverdrup	 H.
"<The> Odyssey.-- Doubleday, 1963"	Homero	 s. IX a. de J. C.
"<The> Odyssey.-- Doubleday, 1963"	s/a	
"<The> Odyssey.-- Doubleday, 1963"	s/a	
"<The> Odyssey.-- Doubleday, 1963"	s/a	
"<The> O'Hara generation.-- Random House, 1969"	O'Hara	 John
"<The> ojibwa woman.-- Columbia university press, 1938"	Landes	 Ruth
"<The> olmec tradition, june 18 to august 25, 1963.-- The Museum of Fine Arts, 1963"	s/a	
"<The> Ontogeny of insects. Acta symposii de evolutione insectorum prague 1959.-- Academic Press, 1960"	s/a	
"<The> Oral approach to English teaching.-- Instituto Mexicano Norteamericacn de Relaciones Culturales, 1968"	American English Course	
"<The> Ordways.-- A.A. Knopf, 1965"	Humphrey	 William
"<The> Organization of cells and other organisms.-- Clarendon Press, 1962"	Picken	 Laurence Ernest Rowland
"<The> oriental institute.-- The University of Chicago Press, 1933"	Breasted	 James Henry
"<The> Origin of adaptations.-- Columbia University, 1963"	Grant	 Verne
"<The> origin of corn.-- University, 1941"	Whiting	 Alfred F.
"<The> origin of indian corn and its relatives.-- Agricultural and Mechanical College, 1939"	Mangelsdorf	 Paul C.
"<The> origin of species by means of natural selection; or, the preservation of favoured races in the struggle for life.-- Penguin Books, 1968"	Darwin	 Charles Robert
"<The> original writings and correspondence of the two Richard Hakluyts.-- Hakluyt Society, 1935"	Taylor	 E.G.R.
"<The> original writings and correspondence of the two Richard Hakluyts.-- Hakluyt Society, 1935"	s/a	
"<The> origins and history of the mayas.-- Research Pub., 1945"	Jakeman	 M. Wells
"<The> Origins of culture.-- Harper, 1958"	Tylor	 Sir Edward Burnett
"<The> other americans; our neighbors to the south.-- C. Scribner's sons, 1943"	Tomlinson	 Edward
"<The> Oto.-- Columbia university press, 1937"	Whitman	 William
"<The> Oxford history of India.-- Clarendon Press, 1967"	Smith	 Vicent Arthur
"<The> Oxford history of medern India 1740-1947 (The Oxford history of India, Part III).-- Clarendon Press, 1965"	Spear	 Thomas George Percival
"<The> Oxford history of the emerican people.-- Oxford University Press, 1965"	Morison	 Samuel Eliot
"<The> Oxford history of the emerican people.-- Oxford University Press, 1965"	s/a	
"<The> Oxidation states of the elements and their potentials in aqueous solutions.-- Prentice-Hall, 1952"	Latimer	 Wendell M.
"<The> Pan American highway from the Rio Grande to the Canal zone.-- D. Appleton-Century company, incorporated, 1940"	Franck	 Harry Alverson
"<The> Pattern of animal communities.-- Mathuen, 1966"	Elton	 Charles Sutherland
"<The> Pawnee ghost dance hand game; a study of cultural change.-- Columbia university press, 1933"	Lesser	 Alexander
"<The> Peasant and the communes.-- Dragonfly Books, 1963"	Lethbridge	 Henry J.
"<The> peninsula of Yucatan; medical, biological, meteorological and sociological studies.-- Carnegie institution of Washington, 1933"	Shattuck	 George Cheever
"<The> people and politics of Latin America; a history.-- Ginn and company, [c1903]"	Williams	 Mary Wilhelmine
"<The> people of Mexico; who they are and how they live.-- Harper and brothers, c1921"	Thompson	 Wallace
"<The> Peregrine falcon in Greenland : observing an Endangered species.-- University of Missouri, 1979"	Harris	 James T.
"<The> Personal Archive of Francisco Morazán.-- Tulane University, 1977"	Griffith	 William J.
"<The> Personal narrative of James O. Pattie, of Kentucky.-- University Microfilms, 1966"	Pattie	 James Ohio
"<The> Philosophy of William James. Selected from his chief works.-- The Modern Library, s.f"	James	 William
"<The> Physical foundation of biology, an analytical study.-- Pergamon Press, 1958"	Elsasser	 Walter M.
"<The> Physical sciences.-- 2d. ed.-- Prentice-Hall, 1946"	Cable	 Emmett James
"<The> Physicology and biochemistry of herbicides.-- Academic Press, 1964"	Audus	 Leslie John
"<The> Physics of electricity and magnetism.-- John Wiley, 1959"	Scott	 William Taussig
"<The> Physiological clock : endogenous diurnal rhythms and biological chronometry.-- Academic Press, 1964"	Bunning	 Erwin
"<The> Physiology of cells.-- Macmillan, 1968"	Guthe	 Karl F.
"<The> Physiology of insects.-- Academic Press, 1964"	Rochstein	 Morris
"<The> Physiology of insects.-- Academic Press, 1964"	s/a	
"<The> Physiology of mammals and other vertebrates.-- University Press, 1965"	Marshall	 P.T.
"<The> Physiology of mosquitoes.-- Macmillan, 1963"	Clements	 Alen Neville
"<The> Picture of Dorian Gray.-- Modern Library, 1954"	Wilde	 Oscar
"<The> Pilgrim project.-- McGraw-Hill Book Company, 1964"	Searls	 Hank
"<The> Plant kingdom.-- Prentice Hall, 1964"	Bold	 Harold C.
"<The> Plant kingdom.-- Prentice Hall, 1964"	s/a	
"<The> Plant kingdom.-- Prentice Hall, 1964"	s/a	
"<The> Plant kingdom.-- Prentice Hall, 1964"	s/a	
"<The> Plant kingdom.-- Prentice Hall, 1964"	s/a	
"<The> Plant world, a text in college botany.-- Rinehart and Winston, 1964"	Fuller	 H. J.
"<The> pocket guide to the West Indies.-- Sifton, Praed and co., 1927"	Aspinall	 Sir Algernon Edward
"<The> Polarographic method of analysis.-- Chemical Education Pub., 1956"	Müller	 Otto H.
"<The> political geography of the Yucatan maya.-- Carnegie Institution of Washington, 1957"	Roys	 Ralph Loveland
"<The> Political philosophy of the conquest of America.-- Culture, 1953"	Zavala	 Silvio
"<The> Politics of mass society.-- McMillan, 1961"	Kornhauser	 William
"<The> pottery of Pecos.-- Phillips Academic by the Yale University Press, 1936"	s/a	
"<The> practical stylist.-- Harper and Row, 1962"	Baker	 Sheridan
"<The> practical stylist.-- Harper and Row, 1962"	s/a	
"<The> Practical use of the microscope, including photomicrography.-- s.e., 1958"	Needham	 George Herbert
"<The> Practice of management.-- Harper, 1954"	Drucker	 Peter F.
"<The> Practice of psychotherapy ; essays on the psycholoy of the transference and other subjects.-- s.e., 1954"	Jung	 Carl Gustav
"<The> Pre-columbian mind: a study into the aberrant nature of sexua drives, drugs affecting behaviour and the attitide towards life and death with a survey of psychotherapy in Precolumbian America.-- Seminar Press, 1971"	Guerra	 Francisco
"<The> Predicament of democratic man.-- Maciadden-Bartell, 1971"	Cahn	 Edmon
"<The> prehistory of East Africa.-- Macmillan, 1963"	Cole	 Sonia Mary
"<The> Prehistory of the theory of distributions.-- Springer-Verlag, 1982"	Lutzen	 Jesper
"<The> Preservation of books in tropical and subtropical countries.-- Oxford University Press, 1964"	Plumbe	 Wilfred J.
"<The> Press and the Constitution: 1931-1947.-- University of Minnesota Press, [1947]"	Gerald	 J. Edward
"<The> Price system and resource allocation.-- Holt, 1965"	Leftwich	 Richard H.
"<The> Prime minister's daugter.-- Randon House, 1965"	Edelman	 Maurice
"<The> Primitive world and its transformations.-- Cornell University Press, 1963"	Redfield	 Robert
"<The> Principles of chemical equilibrium with applications in chemistry and chemical engineering.-- University Press, 1971"	Denbigh	 Kenneth
"<The> Principles of economics geology.-- McGraw-Hill, 1940"	Emmons	 William Harvey
"<The> Principles of optics.-- McGraw-Hill, 1932"	Hardy	 Arthur C.
"<The> Principles of production control.-- Macdonald and Evans, 1968"	Burbidge	 John L.
"<The> problem of Atlantis.-- W. Rider and son, limited., 1924"	Spence	 Lewis
"<The> Production function in business : fundamentals and analysis for management homewood.-- Richard D. Irwin, 1962"	Timms	 Howard L.
"<The> Progressive movement 1900-1915 with an introduction.-- Prentice-Hall, 1963"	Hofstadter	 Ricahrd
"<The> Promise.-- Knopf, 1969"	Potok	 Chaim
"<The> Proton in chemistry.-- Cornell University Press, 1959"	Bell	 R.P.
"<The> Provincial deputation in Mexico : Harbinger of provincial autonomy, independence and federalism.-- University of Texas Press, 1992"	Benson	 Nettle Lee
"<The> Public arts.-- Simon and Schuster, 1956"	Seldes	 Gilbert Vivian
"<The> pueblo indian world; studies on the natural history of the Rio Grande valley in relation to Pueblo Indian.-- The University of New Mexico and the School of American Research, 1945"	Hewett	 Edgar Lee
"<The> Purple Quest : a novel of seafaring adventure in the ancient world.-- Doubleday, 1965"	Glaughter	 Frank G.
"<The> Purple Quest : a novel of seafaring adventure in the ancient world.-- Doubleday, 1965"	s/a	
"<The> queens confession.-- Doubleday, 1968"	Holt	 Victoria
"<The> quest and occupation of Tahiti by emissaries of Spain during the years 1772-1776; told in despatches and other contemporary documents.-- Hakluyt Society, 1919"	Corney	 Bolton Glanvill
"<The> rain forests of golfo Dulce.-- University of Florida Press, 1956"	Allen	 Paul Hamilton
"<The> rainbow republics, Central America.-- Coward-McCann, 1947"	Hancock	 Ralph
"<The> Random house handbook.-- Random House, 1974"	Crews	 Frederick
"<The> Random house handbook.-- Random House, 1974"	s/a	
"<The> Random House workbook.-- Random House, 1976"	Kaufman	 Jule
"<The> Raymond Wielgus collection; catalogue of the exhibition.-- University Publishers, 1960"	New York. Museum of Primitive Art	
"<The> red man's continent; a chronicle of aboriginal America.-- Yale University press, 1920"	Huntington	 Ellsworth
"<The> Regulation of cell metabolism.-- Hermann, 1968"	Cohen	 Georges N.
"<The> religion of the aztecs.-- Central News co., 1937"	Caso	 Alfonso
"<The> Republic of Korea : a political and economic study. Ussued under the auspices of the Royal Institute of International Affairs.-- Oxford University Press, 1963"	Reeve	 W. D.
"<The> republic of Mexico in 1876. A political and ethnographical division of the population, character, habits, costumes and vocations of its inhabitants.-- La enseñanza printing office, 1876"	García Cubas	 Antonio
"<The> republic of Mexico, its agriculture, commerce and industries; a handbook of information based upon exhaustive research work carried on in the different sections of Mexico.-- N.L. Brown, 1924"	Schnitzler	 Hermann
"<The> Rice-Sprout song.-- Dragonfly Books, 1966"	Chang	 Eileen
"<The> riches of Mexico and its institutions.-- Nixon-Jones printing co., 1893"	Duclós Salinas	 Adolfo
"<The> rise and fall of maya civilization.-- 1st. ed..-- University of Oklahoma Press, 1954"	Thompson	 John Eric Sidney
"<The> rise of Fernando Cortés.-- The Cortes society, 1944"	Wagner	 Henry Raup
"<The> rock book.-- Doubleday, Doran and co., 1940"	Fenton	 Carroll Lane
"<The> Roman.-- G. P. Putnam's Sons, 1964"	Waltari	 Mika
"<The> romance and rise of the american tropics.-- Doubleday, Doran and company, inc., 1929"	Crowther	 Samuel
"<The> Rorschach experiment: ventures in blind diagnosis.-- Grune and Stratton, 1960"	Beck	 Samuel
"<The> Rosalie Evans letters from Mexico.-- The Bobbs-Merrill company, c1926"	Evans	 rosalie (Caden) d. 1924
"<The> royal road to Mexico; a travel log- an interpretation- a plea for friendship.-- the Watergate publishing company, 1937"	Pellowe	 William Charles Smithson
"<The> royal tombs of Ur the chaldees. The treasures discovered by the joint expedition of....-- The Museum of the University, 1939"	s/a	
"<The> rubber-ball games of the Americas.-- J.J. Augustin, 1950"	Stern	 Theodore
"<The> ruins at Tiahuanaco.-- s.e., s.f."	Bandelier	 Adolph Francis Alphonse
"<The> ruins of Zaculeu, Guatemala.-- United Fruit Co., 1953, c1954"	Woodbury	 Richard Benjamín
"<The> ruins of Zaculeu, Guatemala.-- United Fruit Co., 1953, c1954"	s/a	
"<The> Russian discoveries between Asia and America.-- University Microfilms, 1966"	Coxe	 William
"<The> sacred symbols of Mu.-- I. Washburn, 1933"	Churchward	 James
"<The> Satanic verses.-- Viking, 1989"	Rushdie	 Salman
"<The> savage my kinsman.-- 1st ed..-- Harper, 159 p."	Elliot	 Elisabeth
"<The> scallop; studies of a shell and its influence on humankind.-- Shell Transport and Trading Co., 1957"	Cox	 Ian
"<The> Scattering of light : and other electromagnetic radiaton.-- Academics Press, 1969"	Kerker	 Milton
"<The> Science of biology.-- McGraw-Hill, 1963"	Weisz	 P. B.
"<The> Science of botany.-- McGraw-Hill, 1962"	Weisz	 Paul B.
"<The> Science of botany.-- McGraw-Hill, 1962"	Fuller	 Melvin S.
"<The> science of culture, a study of man and civilization.-- Farrar, Straus, 1949"	White	 Leslie A.
"<The> Science of evolution.-- Macmillan, 1977"	Stansfield	 William D.
"<The> Science of genetics : an introduction to heredity.-- 4th. ed.-- Macmillan, 1980"	Burns	 George W.
"<The> Science of life.-- Doran and Co., 1931"	Wells	 H. G.
"<The> Science of zoology.-- 2a. ed.-- McGraw-Hill Book, 1973"	Weiz	 Paul B.
"<The> Scientific revolution, 1500-1800: the formation of modern scientific attitude.-- Baecon Press, 1966"	Hall	 Alfred Rupert
"<The> Sea and the stare.-- G. P. Putnam's Sons, 1967"	Wilder	 Robert
"<The> Sea: ideas and observations on progress in the study of the seas.-- J. Wiley, 1963"	Hill	 M.N.
"<The> Seashore.-- Brockhampton Press, 1965"	Street	 Philip
"<The> Seat of power.-- Crown, Publisher, 1965"	Horan	 James D.
<The> Secret and hidden history of man	Arnold	 Ian
"<The> secret of Santa Vittoria.-- Simon and Schuster, 1966"	Criehton	 Robert
"<The> secret of the pacific; a discussion of the origin of the early civilisations of America, the toltecs, aztecs, mayas, incas and their predecessors and of the possibilities of asiatic indluence thereon.-- C. Scribner's sons, 1912"	Enock	 Charles Reginald
"<The> selden roll, an ancient mexican picture manuscript in the Bodleian Library at Oxford.-- Verlag Gebr. Mann, 1955"	s/a	
"<The> seven caves; archaeological explorations in the Middle East.-- 1st. ed..-- Knopf, 1957, c1956"	Coon	 Carleton Stevens
"<The> Sex life of the animals.-- Simon and Schuster, 1965"	Wendt	 Herbert
"<The> Shadow wife.-- Conard-McCarn, 1967"	Eden	 Dorothy
"<The> shape of thought an analytical anthology.-- Harper and Row, 1978"	Bond	 George R.
"<The> Shivering sands.-- Doubleday, 1969"	Holt	 Victoria
"<The> Shope of Britain : a study of retail distribution.-- Routledge and Kegan Paul, 1949"	Levy	 Hermann
"<The> Skills of interviewing.-- Tavistock Pub., 1961"	Sidney	 Elizabeth
"<The> Sleep of reason.-- Scribner's, 1968"	Show	 Charles Percy
"<The> Small arms problem in Central Asia: features and implications.-- United Nations Institute for Disarmament Research, 2000"	Pirseyedi	 Bobi
"<The> Smart retrieval system: experiments in automatic document processing.-- Prentice-Hall, 1971"	s/a	
"<The> Smithsonian institution, 1846-1896. The history of its first half century.-- s.e., 1897"	Smithsonian institution	
"<The> Sociological perspective; introductory readings.-- Little Brown, 1977"	McNall	 Scott G.
"<The> Sociology of natural resources.-- Botterwoths, 1981"	Elliot	 John
"<The> Software encyclopedia 1995 : a guide for personal, proffesional and business users.-- R.R. Bowker, 1995"	s/a	
"<The> Software encyclopedia 1995 : a guide for personal, proffesional and business users.-- R.R. Bowker, 1995"	s/a	
"<The> Solution of initial value problems using interval arithmetic : formulation and analysis of an algorithm.-- Mathematisch Centrum, 1981"	Eijgenraam	 P.
"<The> song of Quetzalcoatl.-- 2d. ed. with twelve illustrations.-- The Antioch press, 1931"	Cornyn	 John Hubert
"<The> Sound of english and spanish.-- University of Chicago Press, [19..]"	Stockwell	 Robert P.
"<The> South american tour.-- George H. Doran company, c1913"	Peck	 Annie Smith
"<The> South Americans.-- Dodd Mead and company, 1915"	Koebel	 William Henry
"<The> southland of North America, rambles and observations in Central America during the year 1912.-- G.P. Putnam's sons, 1913"	Putnam	 George Palmer
"<The> South-west.-- University Microfilms, 1966"	Ingraham	 Joseph Holt
"<The> South-west.-- University Microfilms, 1966"	s/a	
"<The> Spanish colonie.-- University microfilms, 1966"	Casas	 Bartolomé de las
"<The> Spanish conquest in America and its relation to the history of slavery and to the government of colonies.-- J. W. Parker and son., 1855-61"	Helps	 Sir Arthur
"<The> Spanish conquest in America and its relation to the history of slavery and to the government of colonies.-- J. W. Parker and son., 1855-61"	s/a	
"<The> Spanish conquest in America and its relation to the history of slavery and to the government of colonies.-- J. W. Parker and son., 1855-61"	s/a	
"<The> Spanish conquest in America and its relation to the history of slavery and to the government of colonies.-- J. W. Parker and son., 1855-61"	s/a	
"<The> speech chain : the physics and biology of spoken languaje.-- Bell Telephone laboratories for Educational use, 1970"	Denes	 Peter B.
"<The> Spiro mound collection in the museum.-- Museum of the American Indian Heye Foundation, 1945"	Burnett	 Edwin Kenneth
"<The> story of archeology in the Americas.-- Harvey House, 1960"	Elting	 Mary
"<The> story of man; from the first human to primitive culture and beyond.-- 2a. ed. rev..-- Knopf, 1962"	Coon	 Carleton Stevens
"<The> Story of pollination.-- Ronald Press, 1961"	Meesue	 B. J. D.
"<The> story of the american indian.-- Liveright publishing corporation, c1934"	Radin	 Paul
"<The> story of the Panama canal.-- The John C. Winston company, c1913"	Marshall	 Logan
"<The> Strategy of life.-- 2th. ed.-- W. H. Freeman, 1974"	Grobstein	 Clifford
"<The> Structure and functions of the brain.-- Indiana University Press, 1966"	Sarkisov	 S. A.
"<The> Structure of arithmetic and algebra.-- John Wiley, 1961"	María	 May Hickey
"<The> Structure of atoms.-- Houghton Mifflin, 1964"	Lagowski	 J.J.
"<The> Structure of atoms.-- Macmillan, 1967"	Booth	 Verne H.
"<The> Structure of matter.-- John Wiley, 1959"	Rice	 Francis Owen
"<The> Structures of the real number system : a programmed introduction.-- Prentice-Hall, 1967"	Baum	 John O.
"<The> struggle for the Falkland islands, a study in legal and diplomatic history.-- Yale University Press, Oxford University Press, 1927"	Goebel	 Julius
"<The> Study of arithmetic.-- s.e., 1966"	Lay	 L. Clark
"<The> Study of biology.-- 2a. ed.-- Addison-Wesley, 1967"	Baker	 Jeffrey J. W.
"<The> Study of culture at a distance.-- The University of Chicago, 1962"	Mead	 Margaret
"<The> swimmer manuscript; cherokee sacred formulas and medicinal prescriptions.-- Gobernment Printing Office, 1932"	Mooney	 James
"<The> Systematic identification of organic compounds: a laboratory manual.-- John Wiley, 1964"	Shriner	 Ralph L.
"<The> Systems approach.-- Dell Pub., 1968"	Churchman	 C. West
"<The> tarahumara, an indian tribe of northern-Mexico.-- The University of Chicago Press, 1935"	Bennett	 Wendell Clark
"<The> Teaching of mathematics.-- Addison-Wesley, c1951"	Davis	 Davis Roy
"<The> technique of porcupine-quill decoration among the North American Indians.-- The museum of the American Indian, Heye foundation, 1916"	Orchard	 William C.
"<The> temple of the warriors at Chichen Itzá, Yucatan.-- Carnegie Institution of Washington, 1931"	Morris	 Earl Halstead
"<The> temple of the warriors at Chichen Itzá, Yucatan.-- Carnegie Institution of Washington, 1931"	s/a	
"<The> temple of the warriors; the adventure of exploring and restoring a masterpiece of native american architecture in the ruined maya city of Chichen Itzá, Yucatan.-- C. Scribner's sons, 1931"	Morris	 Earl Haltead
"<The> Theory and management of systems.-- McGraw-Hill, 1967"	Johnson	 Richard Arvid
"<The> Theory and practice of scintillation countingScintillation counting.-- Macmillan, 1964"	Birks	 John Betteley
"<The> Theory of atomic spectra.-- Cambridge, 1963"	Condon	 Edward Uhler
"<The> Theory of electrons and its applications to the phenomena of light and radiant heat.-- 2a. ed.-- Dover Publications, 1952"	Lorentz	 Hendrick Antoon
"<The> Theory of elementary particleselementary particles.-- University Press, 1961"	Hamilton	 J.
"<The> Theory of elementary particleselementary particles.-- University Press, 1961"	s/a	
"<The> Theory of functions of real variables.-- McGraw-Hill, 1956"	Graves	 Lawrence Murray
"<The> Theory of groups.-- The Macmillan Co., 1964"	Hall	 Marshall
"<The> Theory of optics.-- Dover Publications, 1959"	Drude	 P.K.L.
"<The> Theory of sound.-- Dover, 1945"	Rayleigh	 Baron
"<The> Theory of the electric and magnetic properties of molecules.-- John Wiley, 1967"	Davies	 D. W.
"<The> Theory of transition-metal ions.-- University Press, 1961"	Griffith	 John Stanley
"<The> Thermodynamics of electrical phenomena in metals and a condensed colletion of thermodynamics formulasElectrical phenomena in metals.-- Dover Publications, 1961"	Bridgman	 P. W.
"<The> Thermodynamics of simple materials with fading memory.-- Springer-Verlag, 1972"	Day	 Willaim Alan
"<The> Thing of it is ....-- Harcourt, 1967"	Goldman	 William
"<The> Thing of it is ....-- Harcourt, 1967"	s/a	
"<The> Thousand hour day.-- Dial Press, 1966"	Kuniczak	 W. S.
"<The> Three principles of the people San Min Chu I..-- China Publisimng, [19..]"	Sun	 Yat-Sen
"<The> three worlds of Latin America; Mexico, Central America and South America.-- [1st ed.].-- Dutton, [1963]"	Worcester	 Donald Emmet
"<The> thurber carnival.-- The Modern Library, 1957"	Thurber	 James
"<The> thurber carnival.-- The Modern Library, 1957"	s/a	
"<The> titles of Ebtun.-- Carnegie Institution of Washington, 1939"	Ebtun	 Yucatán
"<The> tomb of senebtisi at Lisht.-- The Gilliss press, 1916"	Mace	 Arthur Cruttenden
"<The> Tovar calendar; an illustrated mexican manuscript ca. 1585.-- The Academy, 1951"	Tovar	 Juan de
"<The> Toynbee Ikeda dialogue : man himself musta choose.-- Kodansha International, 1976"	Toynbee	 Arnold Joseph
"<The> track of man; adventures of an anthropologist.-- 1st. ed..-- Doubleday, 1953"	Field	 Henry
"<The> Training of journalists: a world wide survey on the training of personnel for the mass media.-- UNESCO, [1958]"	United Nations Educational	 Scientific and Cultural Organitation
"<The> travels and controversies of friar Domingo Navarrete, 1618-1686.-- Hakluyt Society at the University Press, 1962"	Fernández Navarrete	 Domingo
"<The> travels and controversies of friar Domingo Navarrete, 1618-1686.-- Hakluyt Society at the University Press, 1962"	s/a	
"<The> Trickster : a study in american indian mythology.-- Routledge and Kegan Paul, 1956"	Radin	 Paul
"<The> Triumph : a novel of modern diplomacy.-- Houghton Mifflin, 1968"	Galbraith	 John Kenneth
"<The> Triumph of the inmortal-will.-- Selbstverlag Dr. M. Ludendorff, s.f."	Ludendorff	 Matilde (Spiess)
"<The> True history of the conquest of New Spain.-- Printed for the Hakluyt Society, 1908-16"	Díaz del Castillo	 Bernal
"<The> True history of the conquest of New Spain.-- Printed for the Hakluyt Society, 1908-16"	s/a	
"<The> True history of the conquest of New Spain.-- Printed for the Hakluyt Society, 1908-16"	s/a	
"<The> True history of the conquest of New Spain.-- Printed for the Hakluyt Society, 1908-16"	s/a	
"<The> True history of the conquest of New Spain.-- Printed for the Hakluyt Society, 1908-16"	s/a	
"<The> true Mexico, Mexico-Technotitlan.-- Priv. pub. by the author, 1938"	Deverdun	 Alfred Louis
"<The> Twenties : American writing in the postwar decade.-- Collier Books, 1962"	Hoffman	 Frederick J.
"<The> two crosses of Todos Santos, survivals of mayan religious ritual.-- Pantheon Books, 1951"	Oakes	 Maud van Cortlandt
"<The> Two crosses, a novel.-- S.a.m.d.t., 1975"	Petrow	 Lu-Ki-Yuan
"<The> Unexpacted revolution : social forces in the Hungarian uprising.-- University Press, 1961"	Kecskemeti	 Paul
"<The> United Fruit Company in Latin America.-- National Planning Association, 1958"	May	 Stacy
"<The> United States and Canada.-- Prentice-Hall, 1964"	American Assembly. Columbia University	
"<The> United States and latin america.-- 2a. ed.-- Prentice-Hall, 1964"	American Assembly	
"<The> United States and latin america.-- 2a. ed.-- Prentice-Hall, 1964"	s/a	
"<The> United States and Latin America.-- Doubleday, Page and company, 1920"	Latané	 John Holladay
"<The> United States and Latin America; background papers and the final report of the sixteenth american assembly. Arden house, harriman campus of Columbia University, Harriman, New York, october 15-18, 1959. Final ed..-- s.e., 1959"	American Assembly	
"<The> United States and the far east.-- 2a. ed.-- Prentice-Hall, 1962"	American Assembly. Columbia University	
"<The> United States and the far east.-- 2a. ed.-- Prentice-Hall, 1962"	s/a	
"<The> United States and the independence of Latin America, 1800-1830.-- Russell and Russell, 1962, c1941"	Whitaker	 Arthur Preston
"<The> United States and the latin american revolution.-- UCLA, 1972"	Needler	 Matin C.
"<The> University today: its role and place in society: an international study.-- World University Service, 1960"	Ducrat	 Bernard
"<The> untold story of Panama.-- Athene Press, 1959"	Hearding	 Earl
"<The> Urinary tract ; roentgen diagnosis.-- Year Book Medical Publishers, 1967"	Thornbury	 John R.
"<The> USSR and the future: an analysis of the New Program of the CPSU.-- F. A. Praeger, 1963"	Sahpiro	 Leonard Bertram
"<The> USSR and the future: an analysis of the New Program of the CPSU.-- F. A. Praeger, 1963"	s/a	
"<The> USSR olympiad problem book : selected problems and theorems of elementary mathematics.-- W. H. Freeman, 1962"	Shklarsky	 D. D.
"<The> vegetation of Peten. With an appendix: Studies of....-- Carnegie institution of Washington, 1937"	Lundell	 Cyrus Longworth
"<The> vegetation of Peten. With an appendix: Studies of....-- Carnegie institution of Washington, 1937"	s/a	
"<The> Vertebrate story.-- 4th. ed.-- University of chicago Press, 1959"	Romer	 Alfred Sherwood
"<The> Vertebrats body ; by Alfred Sherwood Romer and Thomas S. Parsons.-- 5th. ed.-- W.B. Saunders, 1977"	Romer	 Alfred Sherwood
"<The> Vigilantes of Montana.-- University Microfilms, 1966"	Dimsdale	 Thomas Josiah
"<The> village shield; a story of Mexico.-- E,P. Dutton and company, c1917"	Gaines	 Ruth Louise
"<The> Vines of Yarrabee.-- Coward, McConn, 1969"	Eden	 Dorothy
"<The> Vocabulary of Japanese Literary Aesthetics.-- Centre for East Asian Cultural Studies, 1963"	Hisamatsu	 Se'ichi
"<The> voyage of captain Don Felipe Gonzalez; in the ship of the line San Lorenzo, with the frigats, Santa Rosalia in Company, to Easter Island in 1770-1. Preceded by an extract from Mynheer Jacob Roggeveen's official log of his discovery of and visit to Easter Island in 1722.-- Hakluyt Society, 1908"	Corney	 Bolton Glanvill
"<The> voyages and travels of Captain Nathaniel Uring.-- Cassell, 1928"	Uring	 Nathaniel
"<The> Walking stick.-- Doubleday, 1967"	Graham	 Winston
"<The> War in Florida.-- Universty Micrifilms, 1966"	Potter	 Woodburns
"<The> Ward of Quito.-- Printed for the Hakluyt society, 1913"	Cieza de León	 Pedro de
"<The> Wax boom.-- Randon House, 1962"	Mandel	 George
"<The> Ways of the poem.-- Prentice Hall, 1963"	Miles	 Josephine
"<The> Wealth of nations.-- J.M. Dent and Sons Ltd., 1954"	Smith	 Adam
"<The> West Indies with British Guiana and British Honduras.-- New and rev. ed..-- E. Nash and Grayson, limited, 1930"	Manington	 George
"<The> Wine and the music.-- Doubleday, 1968"	Barreth	 William Edmund
"<The> Wonderful world of food ; the substance of life.-- Garden City Books, 1958"	Boyd-Orr	 John Boyd Orr
"<The> wood-carver's art in ancient Mexico.-- Museum of the american indian, Heye foundation, 1925"	Saville	 Marshall Howard
"<The> Works of Plato.-- The Modern Library, 1956"	Edman	 Irwin
"<The> World almanac and book of facts, 1997.-- World Amanac Books, 1996"	s/a	
"<The> World almanac and book of facts, 1997.-- World Amanac Books, 1996"	s/a	
"<The> World almanac and book of facts.-- World almanac, [19..]"	s/a	
"<The> World almanac and book of facts.-- World almanac, [19..]"	s/a	
"<The> World almanac and book of facts.-- World almanac, [19..]"	s/a	
"<The> World almanac and book of facts.-- World almanac, [19..]"	s/a	
"<The> World araund us.-- Collier, 1963"	Sutton	 Graham
"<The> World encompassed.-- University Microfilms, 1966"	Drake	 Sir Francis
"<The> World of biology.-- McGraw-Hill, 1979"	Davis	 P. William
"<The> World of primitive man.-- H. Schyuman, 1953"	Radin	 Paul
"<The> World of primitive man.-- H. Schyuman, 1953"	s/a	
"<The> writer's resource : reading for composition.-- McGraw-Hill, 1983"	Day	 Susan
"<The> writer's work.-- Prentice-Hall, 1980"	Memering	 Dean
"<The> young man's chances in South and Central America; a study of opportunity.-- D.C. Southern commercial congress, c1914"	Reid	 William Alfred
"<Un< Estudio de la educación agrícola universitaria en américa latina.-- Organización de las Naciones Unidas para la Agricultura y la Alimentación, 1959"	Chaparro	 Alvaro
"<Un> americano en el infierno.-- Grijalbo, 1966"	Van Peebles	 Melvin
"<Un> Amor moderno.-- Luis de Carolt, 1960"	Lawrence	 David Herbert
"<Un> Cirio gotea en la sombra (19 testimonios de un cristiano del siglo XX).-- Editorial Procer, 1967"	Rodríguez Garavito	 Agustín
"<Un> Día de Octubre en Santiago.-- Claves, 1982"	Castillo	 CArmen
"<Un> Día de Octubre en Santiago.-- Claves, 1982"	s/a	
"<Un> Día en la vida de Iván Denisovich : novela.-- Plaza Janes, 1975"	Solzhenitsyn	 Alexander Iseavich
"<Un> Enfoque práctico para la planificación del currículo.-- El Ateneo, 1974"	Schawab	 Joseph J.
"<Un> Eslabón perdido en la historia: piratería en el caribe, siglos XVI y XVII.-- UNAM, 1983"	Jarmy Chapa	 Martha
"<Un> Estadista de América: obra sociopolítica de Trujillo (filosofía-historia-estadística).-- Montavo, 1945"	Mota M.	 Fabio A.
"<Un> Fraile prócer y una fábula poema (Estudio acerca de Fray Matías de Córdova).-- Tip. Nacional, 1932"	Guillén	 Flavio
"<Un> grito en la noche : novela de amor y de dolor.-- s.ed., s.f."	Mata	 Pedro
"<Un> Hijo de la revolución.-- Cosmos, 1963"	Gabrilovich	 Euguoni Gaipovich
"<Un> Hombre cabal : pieza en dos actos.-- Fabril Editora, 1963"	Bolt	 Robert
"<Un> Hombre ejemplar (drama en dos actos, divididos en dos cuadros).-- Papeles de son Armadans, 1956"	Lázaro Carreter	 Fernando
"<Un> hombre muerto a puntapie.-- Casa de las Américas, 1982"	Palacio	 Pablo
"<Un> Momento en Pekín : novela de la vida contemporánea China.-- Sudamericana, 1945"	Lin	 Yutang
"<Un> Mundo en cine.-- Marymar, 1972"	Kauffmann	 Stanley
"<Un> Mundo indivisible con libertad y justicia para todos.-- Edicones la Isla, 1956"	Adenauer	 Konrad
"<Un> mundo para julius.-- Barral, 1970"	Bryce Echenique	 Alfredo
"<Un> Mundo restaurado : la politica del conservadurismo en una época revolucionaria.-- Fondo de Cultura Económica, 1973"	Kissinger	 Henry A.
"<Un> Mundo restaurado : la politica del conservadurismo en una época revolucionaria.-- Fondo de Cultura Económica, 1973"	s/a	
"<Un> Mundo sin guerra.-- Lautaro, 1964"	Bernal	 John Desmond
"<Un> Mundo sobrepoblado.-- Pax-México, 1971"	Fisher	 Tadd
"<Un> Mundo sobrepoblado.-- Pax-México, 1971"	s/a	
"<Un> Mundo sobrepoblado.-- Pax-México, 1971"	s/a	
"<Un> Mundo sobrepoblado.-- Pax-México, 1971"	s/a	
"<Un> Mundo sobrepoblado.-- Pax-México, 1971"	s/a	
"<Un> Mundo sobrepoblado.-- Pax-México, 1971"	s/a	
"<Un> Mundo sobrepoblado.-- Pax-México, 1971"	s/a	
"<Un> Mundo sobrepoblado.-- Pax-México, 1971"	s/a	
"<Un> Municipio medieval castellano-leonés durante el siglo XV: ciudad Rodrigo.-- Universidad de Salamanca, 1986"	Bernal Estevez	 Angel
"<Un> Niño en la revolución mexicana.-- Instituto de Cultura de Tabasco, 1985"	Iduarte Foucher	 Andrés
"<Un> Niño en la revolución mexicana.-- Instituto de Cultura de Tabasco, 1985"	s/a	
"<Un> Novelista descubre América (Chile en el ojo ajeno).-- Nacional, 1946"	Delibes	 Miguel
"<Un> Novelista descubre América (Chile en el ojo ajeno).-- Nacional, 1946"	s/a	
"<Un> Nuevo concepto de la dirección administrativa.-- Ediciones Deusto, 1963"	American Management Association	 Inc. New York
"<Un> Nuevo concepto del periodismo: reportajes interpretativos.-- Pax-México, 1968"	Copple	 Neale
"<Un> Nuevo concepto del periodismo: reportajes interpretativos.-- Pax-México, 1968"	s/a	
"<Un> Nuevo concepto del periodismo: reportajes interpretativos.-- Pax-México, 1968"	s/a	
"<Un> Nuevo mundo para ingenieros.-- Ediciones Marymar, 1974"	Heald	 Henry T.
"<Un> oscuro pueblo sonriente.-- Casa de las Américas, 1982"	Soto	 Pedro Juan
"<Un> Paseo con William James.-- Fondo de Cultura Económica, 1986"	Barzun	 Jacques
"<Un> posible códice de El Mirador, Chiapas.-- Departamento de Prehistoria. Instituto Nacional de Antropología e Historia, 1970"	Angulo V.	 Jorge
"<Un> Primer curso de funciones complejas.-- Continental, 1973"	Jameson	 G. J. O.
"<Un> Programa de estabilidad monetaria y reforma bancaria.-- Deusto, 1962"	Friedman	 Milton
"<Un> pueblo donde no pasaba nada : novela del tiempo quieto.-- Universidad Central de las Villas. Dirección de Públicaciones, 1962"	Suárez Solís	 Rafael
"<Un> pueblo, un siglo y un hombre (1810-1910).-- Imp. de Ignacio Escalante, 1909"	Hernández	 Fortunato
"<Un> Reconocimiento de Sierra Leona: apuntes de un diario de campo.-- UNAM, 1978"	Navarrete	 Carlos
"<Un> sitio procerámico en Yanhuitlán, Oaxaca.-- Instituto Nacional de Antropología e Historia, 1958"	Lorenzo	 José Luis
"<Un> sueño americano.-- Planeta, 1965"	Mailer	 Norman
"<Un> Viaje por Honduras.-- EDUCA, 1971"	Lester	 MAry
"<Un> Viaje por Honduras.-- EDUCA, 1971"	s/a	
"<Un> Viaje por Honduras.-- EDUCA, 1971"	s/a	
"<Un> Viaje por Honduras.-- EDUCA, 1971"	s/a	
"<Un> Viaje por Honduras.-- EDUCA, 1971"	s/a	
"<Un> Viaje por Honduras.-- EDUCA, 1971"	s/a	
"<Un> Vistazo al pasado de la educación en El Salvador ; El sistema escolar de El Salvador en el siglo XIX.-- 1a. ed..-- Ministerio de Educación, 1995"	LIndo-Fuentes	 Héctor
"<Un> Vistazo al pasado de la educación en El Salvador ; El sistema escolar de El Salvador en el siglo XIX.-- 1a. ed..-- Ministerio de Educación, 1995"	Aguilar Aviles	 Gilberto
"<Una> Aportación a la teoría del ciclo económico.-- 3a. ed.-- Aguilar, 1963"	Hicks	 J. R.
"<Una> Base fundamental para el desarrollo de la productividad agrícola.-- Instituto Interamericano de Ciencias Agrícolas de la OES, 1968"	Anderson	 H. Colvert
"<Una> Caricatura del marxismo.-- Roca, 1973"	Lenin	 Vladimir Ilich
"<Una> Caricatura del marxismo.-- Roca, 1973"	s/a	
"<Una> Caricatura del marxismo.-- Roca, 1973"	s/a	
"<Una> Caricatura del marxismo.-- Roca, 1973"	s/a	
"<Una> Caricatura del marxismo.-- Roca, 1973"	s/a	
"<Una> carta imaginaria de un hombre imaginario en el lecho marinero de la playa.-- Cultura 2, 1987"	Lemus	 William
"<Una> casa dividida: escritos debates 1837-1861.-- Tres Américas, 1965"	Lincoln	 Abraham
"<Una> casa dividida: escritos debates 1837-1861.-- Tres Américas, 1965"	s/a	
"<Una> ciudad histórica (Antigua Guatemala) su pasado y su presente.-- Imp. La República, 1907"	Castañeda	 Francisco
"<Una> Ciudad y dos familias.-- Jus, 1970"	Aguilar Belden de Garza	 Sara
"<Una> clara llamada. Historia novelada.-- Claridad, 1955"	Sinclair	 Upton
"<Una> cortina de follaje y otros relatos.-- Anagrama, 1982"	Welty	 Eudora
"<Una> Cuerda de nylon y oro y otros cuentos maravillosos.-- Ministerio de Educación, 1969"	Menen Desleal	 Alvaro
"<Una> dama solitaria.-- EMECE, 1976"	Robin	 Harold
"<Una> desastrada negociación diplomática, el Tratado de Fronteras y Libre Navegación de los ríos venezolanos firmado entre Venezuela y Colombia.-- s.e., 1949"	Planas Suárez	 Simón
"<Una> Escritora costarricense: Yolanda Oreamuno : ensayo crítico.-- Castilla de Oro, 1968"	Urbano	 Victoria
"<Una> excursión a los indios ranqueles.-- Fondo de Cultura Económica, 1947"	Mansilla	 Lucio Victorio
"<Una> Experiencia de participación y gestión local.-- Programa de Desarrollo Humano Sostenible, 1998"	Programa de Desarrollo Humano Sostenible (PDHS)	
"<Una> Filosofía de lo universal.-- 2a. ed.-- Ediciones Prosveta, 1989"	Aivanhov	 Omraam Mikhael
"<Una> Granja humana.-- Ediciones de Cultura Hispánica, 1973"	Prim Setentill	 J.M.
"<Una> Historia de la psicología moderna.-- McGraw-Hill, 1998"	s/a	
"<Una> Innovación en la enseñanza superior: sistema de instrucción personalizada.-- Limusa, 1974"	Instituto Tecnológico de Estuidos Superiores de Monterrey	
"<Una> Interpretación de la historia universal : en torno a Toynbee.-- Revista de Occidente, 1960"	Ortega y Gasset	 José
"<Una> Interpretación marxista y cristiana de la ciencia contemporánea.-- Universidad Central de Venezuela, 1969"	Marrero	 José Rafael
"<Una> muchacha sin importancia.-- Juventud, 1945"	Tomás	 Mariano
"<Una> Nación de borregos.-- Grijalbo, 1962"	Lederer	 William J.
"<Una> Política económica para el mundo libre : una política económica para los Estados Unidos y para el mundo libre.-- Editorial Norma, 1967"	Rauss	 Henry S.
"<Una> Política económica para el mundo libre : una política económica para los Estados Unidos y para el mundo libre.-- Editorial Norma, 1967"	s/a	
"<Una> Política monetaria para América Latina.-- CEMLA, 1966"	Uri	 Pierre
"<Una> Política monetaria para América Latina.-- CEMLA, 1966"	s/a	
"<Una> Psicología de hoy.-- 20a. ed.-- Herder, 1982"	Cerda	 Enrique
"<Una> punta acanalada del Rancho ""La Chuparrosa"".-- INAH, 1959"	González Rul	 Francisco
"<Una> sóla tierra: el cuidado y conservación de un pequeño planeta.-- Fondo de Cultura Económica, 1972"	Ward	 Barbara
"<Una> sóla tierra: el cuidado y conservación de un pequeño planeta.-- Fondo de Cultura Económica, 1972"	Dubos	 René
"<Una> Teoría científica de cultura.-- Zahar, 1962"	Malinowski	 Bronislaw
"<Una> Teoría científica de la cultura y otros ensayos.-- Sudamericana, 1967"	Malinowki	 Bronislaw
"<Una> Teoría científica de la cultura y otros ensayos.-- Sudamericana, 1967"	s/a	
"<Una> Teoría científica de la cultura y otros ensayos.-- Sudamericana, 1967"	s/a	
"<Una> Venus marina : un acompañante para el paisaje de Rodas.-- Sudamericana, 1969"	Durrell	 Lawrence
"<Una> Vida.-- Casa de las Américas, 1979"	Richmond	 Angus
"<Una> Vida.-- Gráfica Editora Colón, [19..]"	Maupassant	 Guy de
"<Una> Vida.-- Gráfica Editora Colón, [19..]"	s/a	
">Los> Medios de comunicación en los tiempos de crisis.-- Siglo Veintiuno, 1988"	Mattelart	 Armand
">Los> Medios de comunicación en los tiempos de crisis.-- Siglo Veintiuno, 1988"	Mattelart	 Michelle
"1°, Programa y fundamentos de economía.-- S.E., 1970"	Curso de evaluacíon de proyectos	
"1°, Programa y fundamentos de economía.-- S.E., 1970"	s/a	
"1°, Programa y fundamentos de economía.-- S.E., 1970"	s/a	
"1°, Programa y fundamentos de economía.-- S.E., 1970"	s/a	
"10 años de la Declaración de Cartagena sobre Refugiados : declaración de San José sobre refugiados y personas desplazadas 1994.-- ACNUR, IIDH, 1994"	s/a	
"10 epójes y sus variaciones.-- Ediciones amón, 1976"	Athilano	 Andrés
"10 plagas de la globalización neoliberal.-- Asociación Equipo Maíz, 1999"	Cavada	 Miguel
"10 plagas de la globalización neoliberal.-- Asociación Equipo Maíz, 1999"	Aguilar	 José Víctor
"10 plagas de la globalización neoliberal.-- Asociación Equipo Maíz, 1999"	s/a	
"10 principios de análisis estructural educativo : metodología y técnicas para la educación.-- 2a. ed..-- Editorial Trillas, 1999"	Solano Flores	 Guillermo
"10 Principios de análisis estructural educativo.-- Trillas, 1983"	Solano Flores	 Guillermo
"100 años de libertad and coca cola.-- 1a. ed..-- EDUCA, 1990"	Muchnik	 José
"100 años de libertad and coca cola.-- 1a. ed..-- EDUCA, 1990"	s/a	
"100 años de libertad and coca cola.-- 1a. ed..-- EDUCA, 1990"	s/a	
"100 biografías centroamericanas.-- Artes Gráficas, 1971"	Guerrero C.	 Julian N.
"100 preguntas y respuestas sobre el Banco Mundial.-- Banco Mundial, 1970"	s/a	
"100 preguntas y respuestas sobre el Banco Mundial.-- Banco Mundial, 1970"	s/a	
"100 preguntas y respuestas sobre el Banco Mundial.-- Banco Mundial, 1970"	s/a	
"100 relatos breves.-- EDUCA, 1997"	Galeano	 Eduardo
"1001 tips para Windows.-- McGraw-Hill, 1994"	Jamsa	 Kris
"1001 tips para Windows.-- McGraw-Hill, 1994"	s/a	
"1001 ways to improve your conversation and speeches.-- Harper and Brothers, 1952"	Prochnow	 Herbert V.
"1492-1992 un solo mundo.-- Lunwerg Editores S.A., 1990"	s/a	
"150 grandes científicos.-- Editorial Texido Ltda., 1992"	Bridge	 Norman J.
"18 de julio de 1872 muerte del presidente Benito Juaréz.-- Departamento del Distrito Federal, 1987"	s/a	
"1936 os primeros días.-- Edicións Xerais de Galicia, 1993"	s/a	
"1943-Interacción de la nutrición y la infección..-- Editorial Universitaria, 1978"	Selva Sutter	 Ernesto Alfonso
"1943-Interacción de la nutrición y la infección..-- Editorial Universitaria, 1978"	s/a	
"1943-Interacción de la nutrición y la infección..-- Editorial Universitaria, 1978"	s/a	
"1982 United nations list of national parks and protected areas.-- IUCN, 1982"	s/a	
"1985 United Nations List of National Parks and Protected Areas = Liste des nations unies des pares nationaux et des aires protegees 1985.-- IUCN, 1985"	International Union for conservation of nature and natural resources	
"1990 IUCN red list of threatened animals.-- IUCN, 1990"	s/a	
"1993 directory of country environmental studies : an annotated bibliography of environmental ....-- World Resources Institute, 1992"	International Institute for Environment and Development	
"1997 United Nations list of protected areas = Lista de las Naciones Unidas de areas protegidas 1997.-- World Conservation Monitoring Centre : IUCN, 1998"	World Concervation Monitoring Centre	
"1er Encuentro niños, niñas y jóvenes del campo y la ciudad.-- Radda Barnen, 1999"	Radda Barnen de Suecia	
"1ra. guía argentina de gestión de residuos hospitalarios infecciosos.-- s.e., 1995"	Barbieri	 Carlos G.
"20 dibujos mayas.-- Martí, 1965"	Grajeda Mena	 Guillermo
"20 dissenyadors valencians. Disseny industrial i gráfic.-- Institut Valenciá d'Art modern, 1994"	s/a	
"20 personas célebres del mundo norteamericano moderno.-- Limusa Wiley, 1965"	Cooper	 Alice Cecilia
"20 personas célebres del mundo norteamericano moderno.-- Limusa Wiley, 1965"	Palmer	 Charles A.
"20 Poemas de Amor y una canción desesperada..-- Editorial Losada, 1944"	Neruda	 Pablo
"20 rábulas en flux y uno más : ensayo de picaresca.-- 2a. ed.-- José de Pineda Ibarra, 1965"	Herrera	 Flavio
"20th century poetry and poetics.-- 2d. ed.-- Oxford University Press, 1973"	Geddes	 Gary
"21 de Marzo: relación histórica del natalicio del presidente Juárez.-- Departamento del distrito federal, 1983"	Sierra Brabatta	 Carlos J.
"24 poetas búlgaros.-- 1a. ed..-- Editorial Universitaria Centroamericana, 1984"	Vela	 Rubén
"244 preguntas de introducción al derecho.-- Editorial Ariel, 1992"	s/a	
"25 años de estudio y lucha : una cronología del movimiento estudiantil, 1995"	Quezada	 Rufino Antonio
"25 años de estudio y lucha : una cronología del movimiento estudiantil, 1995"	Martínez	 Hugo Roger
"25 años de estudio y lucha : una cronología del movimiento estudiantil, 1995"	s/a	
"25 Estudios de folklore. homenaje a Vicente T. Mendoza y Virginia Rodríguez Rivera.-- UNAM, 1971"	s/a	
"25.000 años de historia subterránea: el apasionante rompecabezas de la arqueología.-- Ediciones Daimon, 1957"	Jessuo	 Ronald Frederick
"29 poemas.-- Centro de Estudios Brasileños, 1978"	Méndez	 Murilo
"3- Cabán (novela).-- José de Pineda Ibarra, 1987"	Del Pinal	 Mauricio
"3 ensayos al servicio del mundo que nace.-- Universidad Autónoma Nacional, Instituto de Investigaciones sociales, 1962"	Monteforte Toledo	 Mario
"3 ensayos al servicio del mundo que nace.-- Universidad Autónoma Nacional, Instituto de Investigaciones sociales, 1962"	s/a	
"3 kilates 8 puntos.-- 2a. ed.-- s.e., 1966"	Romero de Nohra	 Flor
"3 short novels.-- Randon House, 1961"	Fairbairn	 Douglas
"300 millones y tú : Manual para el estudio del Español como lengua vernácula.-- 3a. ed..-- Playor, 1988"	García del Toro	 Antonio
"300 millones y tú : Manual para el estudio del Español como lengua vernácula.-- 3a. ed..-- Playor, 1988"	s/a	
"340 Sepan cuantos -- : 1959-1979.-- Editorial Porrúa, S.A., 1979"	s/a	
"40 años de teatro americano : su historia, sus autores, sus actores.-- Ediciones Losange, 171 p"	Gagey	 Edmond
"40.000 años de arte moderno.-- Taurus, 1959"	Mauduit	 Jacques A.
"4000 años de arquitectura mexicana.-- Libreros Mexicanos Unidos, 1956"	Sociedad de Arquitectos Mexicanos	
"456 adivinanzas.-- 2a. ed., 1997"	Alvarenga Ulloa	 Ciriaco Salvador
"456 adivinanzas.-- 2a. ed., 1997"	s/a	
"4a muestra de dibujo El Salvador 1996.-- CONCULTURA, 1996"	CONCULTURA	
"5 años de jurisprudencia de las Salas Primera (de lo civil) y Terceral (de lo contencioso-administrativo) de la Corte Suprema de Justicia: 1981-1985.-- s.n., 1988"	Arroyo Camacho	 Dulio
"5 intérpretes de la ciudad de México, Diego Rivera, Feliciano Peña y otros.-- Ediciones Mexicanas, 1949"	Crespo de la Serna	 J.J.
"50 años de milagro detrás de las rejas! y otros relatos verídicos inspiradores.-- Interamericana, 1971"	Alberro	 Esther P. de
"50 millones de Franceses.-- Ministerio de Asuntos Extranjeros (Dirección de Servicios de Información y Prensa), s.f."	s/a	
"50 preguntas y respuestas sobre AIF.-- Banco Internacional de Reconstrucción y Fomento, 1970"	s/a	
"500 años de imprenta.-- Ediciones Zeus, 1963"	Steinberg	 S. H.
"500 años de imprenta.-- Ediciones Zeus, 1963"	s/a	
"500 años de imprenta.-- Ediciones Zeus, 1963"	s/a	
"500 años después 1492-1992 : conferencia pronunciada en el Centre Cultural Bancaixa el día 26-XI-91.-- BANCAIXA, 1992"	Fuentes	 Carlos
"6 documentos fundamentales en el estudio de los derechos humanos.-- Editorial Universitaria, 1994"	s/a	
"6 documentos fundamentales en el estudio de los derechos humanos.-- Editorial Universitaria, 1994"	Castillo	 Fabio
"62 modelo para armar.-- Sudamericana, 1968"	Cortázar	 Julio
"62 modelo para armar.-- Sudamericana, 1968"	s/a	
"62 modelo para armar.-- Sudamericana, 1968"	s/a	
"62 modelo para armar.-- Sudamericana, 1968"	s/a	
"658 p..-- 5a ed..-- McGraw-Hill Kogakusha, 1968"	Zemansky	 Mark Waldo
"6a. muestra de dibujo El Salvador 1998.-- Dirección de Publicaciones e Impresos, 1998"	Consejo Nacional para la Cultura y el Arte CONCULTURA	
"7 relatos sobre el amor y la guerra.-- EDUCA, 1986"	Aguilar	 Rosario
"7 relatos sobre el amor y la guerra.-- EDUCA, 1986"	s/a	
"7 relatos sobre el amor y la guerra.-- EDUCA, 1986"	s/a	
"7 relatos sobre el amor y la guerra.-- EDUCA, 1986"	s/a	
"70 años de narrativa argentina : 1900-1970.-- Alianza, 1970"	Yahni	 Roberto
"77 fábulas y algo más.-- Imprenta y Offset Ricaldone, 2000"	Bruni	 Corina
"80 masterpieces from the Gold Museum.-- Banco de la República, 1954"	s/a	
"9 moralistas modernos.-- Herrero Hermanos sucesores, [1965]"	Ramsey	 Paul
"9 moralistas modernos.-- Herrero Hermanos sucesores, [1965]"	s/a	
"9 poetas del Brasil.-- Centro de Estudios Brasileños, 1978"	Bustamante y Ballivián	 Enrique
"A Basic history of the United States.-- The new Home Library, 1944"	Beard	 Charles Austin
"A biblioteca da iguana.-- Edicións Xerais de Galicia, 1994"	Miranda	 Xosé 
"A biology of human concern.-- J. B. Lippincott, 1972"	Etkin	 William
"A bishop amongst bananas.-- W. Gardner, Darton and co., ltd., 1911"	Bury	 Herbert
"A Brief description of New-York.-- University Microfilms, 1966"	Denton	 Daniel
"A Brief history of the pequot war.-- University Microfilms, 1966"	Mason	 John
"A cidade das chuvias.-- Edicións Xerais de Galicia, 1994"	Fernández Ferreiro	 Xosé
"A classification of the biogeographical provinces of the world.-- IUCN, 1975"	Udvardy	 Miklos D. F.
"A classified bibliography of the periodical literature of the trans-Mississippi West.-- Indiana University Press, 1970"	Winter	 Oscar Osburn
"A cociña da primavera : recetario estacional da cociña galega.-- Edicións Xerais de Galicia, [1995]"	Iglesias	 Pepe
"A cociña do outono : recetario estacional da cociña galega.-- Edicións Xerais de Galicia, [1994]"	Iglesias	 Pepe
"A Colection of the Korean studies.-- Korea Foundation, 1995"	Korea Foundation	
"A collection of mathematical problems.-- Interscience, 1960"	Ulam	 S. M.
"A College text-book of physics.-- 3a ed..-- Henry Holt, 1923"	Kimball	 Arthur Lalanne
"A concordance to the inscriptions of Palemque, Chiapas, Mexico.-- Middle American Research Institute. Tulane University, 1996"	Ringle	 William M.
"A Contemporary view of elementary physics.-- McGraw-Hill, 1968"	Borowitz	 Sidney
"A course in APL with applications.-- Addison-Wesley, 1976"	Grey	 Louis D.
"A Course in homological algebra.-- Springer-Verlag, 1970"	Hilton	 Peter John
"A covenant with death.-- 2nd ed..-- McClelland and Stewart, 1964"	Becker	 Stephen
"A critical bibliography for the March of America Series.-- University Micrifilms, 1966"	Klyberg	 Albert T.
"A child's world, infancy through adolescence.-- McGraw-Hill, 1982"	Papalia	 Diane E.
"A dictionary of slang and unconventional english,colloquialisms and catch-phrases solecisms and catachrises nicknames vulgarisms and such Americanisms as have been naturalized.-- Mac Millan, 1970"	Partridge	 Eric
"A dictionary of the Biloxi and Ofo languages, accompanied with thirty one Biloxi texts and numerous Biloxi phrases.-- Govt. print off, 1912"	Dorsey	 James Owen
"A directory of impact assessment guidelines.-- Interaise : IUCN, 1995"	s/a	
"A Directory of United States firms operating in Latin America.-- Unión Panamericana, 1967"	Unión Panamericana. Department of Information and Public Affairs	
"A Field guide to western reptiles and amphibians ; field marks of all species in western North America.-- Houghton Mifflin, 1966"	Stebbins	 Robert C.
"A first course in differentials equations with applications.-- Prindle, Weber and Schmidt, 1979"	Zilla	 Dennis G
"A First course in partial differential equations with complex variables and transform methods.-- Blaidsdel, 1965"	Weinberger	 H. F.
"A Flying trip to the tropics. A record of an ornithological visit to the United States of Colombia, South Ameica and to the Island of Curacao West Indies, in the year, 1982.-- Riverside Press, 1895"	Robinson	 Wirt
"A fortran primer.-- Addison-Wesley, 1963"	Organick	 Elliott I.
"A German community under American occupation : Marburg, 1945-52.-- Stanford Univ. Press, 1961"	Gimbel	 John
"A Germinacao das sementes.-- Secretaría General de la OEA, 1983"	Gouvea Labouriau	 Luiz
"A Germinacao das sementes.-- Secretaría General de la OEA, 1983"	s/a	
"A Germinacao das sementes.-- Secretaría General de la OEA, 1983"	s/a	
"A Germinacao das sementes.-- Secretaría General de la OEA, 1983"	s/a	
"A Germinacao das sementes.-- Secretaría General de la OEA, 1983"	s/a	
"A Gift of joy.-- Crest Books, 1965"	Hayes	 Helen
"A global representative system of marine protected areas.-- Great Barrier Reef Marine Park Authority, IUCN, 1995"	s/a	
"A global representative system of marine protected areas.-- Great Barrier Reef Marine Park Authority, IUCN, 1995"	s/a	
"A global representative system of marine protected areas.-- Great Barrier Reef Marine Park Authority, IUCN, 1995"	s/a	
"A global representative system of marine protected areas.-- Great Barrier Reef Marine Park Authority, IUCN, 1995"	s/a	
"A global strategy for the conservation of marine turtles.-- IUCN, 1995"	s/a	
"A grammar of the cakchiquel languaje of Guatemala.-- McCella and Stavely, 1884"	Brinton	 Daniel Garrison
"A Guide to antibiotic therapy.-- Medical Encyclopedia, 1959"	Welch	 Henry
"A guide to designing legal frameworks to determine access to genetic resources.-- IUCN, 1998"	Glowka	 Lyle
"A Guide to Keynes.-- McGraw-Hill Book, 1953"	Hansen	 Alvin Harvey
"A guide to manusxripts relating to the American Indian in the library of the American Philosophical Society.-- American Philosophical Society, 1966, c1965"	Freeman	 John F.
"A Guide to the study of developmentDevelopment.-- Saunders, 1964"	Newby	 William Wallace
"A guide to undertaking biodiversity legal and institutional profiles.-- IUCN, 1998"	Glowka	 Lyle
"A handbook on north korea.-- Naewoe Press, 1996"	s/a	
"A History of British Honduras.-- Provincial Publishing Co. Ltd., 1946"	Donohoe	 William Arlington
"A History of Hong Kong.-- Oxford University Press, 1964"	Endacott	 G.  B.
"A history of Latin America for schools.-- The Mac-Millan company, 1944"	Inman	 Samuel Guy
"A history of Latin America from the beginnings to the present.-- 2d ed. rev..-- Knopf, 1961"	Herring	 hubert Clinton
"A history of Latin America.-- Prentice-Hall, inc., 1942"	Moore	 David Richard
"A History of Norway.-- University Press, 1965"	Larsen	 Karen
"A history of Peru.-- C.H. Sergel and company, 1892"	Markham	 Clements Robert
"A History of Russia.-- Oxford University Press, 1963"	Riasanovsky	 Nicholas Valentine
"A history of the ancient Southwest.-- Bond Wheelwright Co., 1957"	Gladwin	 Harold Sterling
"A History of the Great War 1914-1918.-- 2a. ed.-- Clarendon Press, 1964"	Cruttwell	 C.   R.  M.   F.
"A history of the Hispanic Society of America, museum and library, 1904-1954; with a survey of the collections.-- Printed by order of the Trustees, 1954"	Hispanic Society of America	
"A History of United States foreing policy.-- 2a. ed.-- Prentice-Hall, 1965"	Pratt	 Julius William
"A Hundred things Japonese, 1975"	Japan Culture Institute	
"A Journal of a missionary tour.-- University Microfilms, 1966"	Scott	 James Leander
"A Journal of the Overland route to California.-- Ann Arbor, Mich., 1966"	Aldrich	 Lorenzo D
"A Journal of travels into the Arkansa territory.-- University Microfilms, 1966"	Nuttall	 Thoams
"A journey in southeastern Mexico: narrative of experiences and observations on agricultural and industrial conditions.-- Priv. print. for the author by the De Vinne press, N.Y., 1910"	Harper	 Henry Howard
"A journey in time: Peruvian pageant.-- The Books-Merril company, [c1937]"	Niles	 Blair
"A la búsqueda de una ética en el periodismo.-- Gernika, 1986"	Goodwin	 H. Eugene
"A la búsqueda del poder: el pensamiento político del siglo XX.-- Troquel, 1967"	Kariel	 Henry S.
"A la diestra mano de las indias : descubrimiento y ocupación colonial de la Baja California.-- Gobierno del Estado de Baja California del Sur. Dirección de Cultura, 1985"	Río Chávez	 Ignacio Alejandro del
"A la hora del sol.-- EDUCA, 1989"	Ochoa	 Américo
"A la luz del fogón; cuentos y narraciones.-- Imprenta Nacional, 1977"	Castillo	 María de los Angeles de
"A la memoria de los héroes de nuestra indpendencia : discursos y poesías del siglo XIX [DGM].-- Cámara Nacional de Comercio de Guadalajara, 1985"	Muria	 José María
"A la sobra de la hora.-- Zig-Zag, 1964"	Díaz Garces	 Joaquín
"A la sombra de Lorca y Buñuel: Eduardo Ugarte.-- Universidad de Alicante, 1995"	s/a	
"A la sombra de Lorca y Buñuel: Eduardo Ugarte.-- Universidad de Alicante, 1995"	Ríos Carratalá	 Juan A.
"A la sombra de Lorca y Buñuel: Eduardo Ugarte.-- Universidad de Alicante, 1995"	s/a	
"A la zaga.-- 2a. ed..-- Clásicos Roxsil, 2000"	Martinez	 Yolanda C.
"A Laboratory manual for general vertebrate zoology.-- Burgess Publishing, 1961"	Lechleither	 R.
"A los pobres del campo : los objetivos de los socialdemócratas explicados para los campesinos.-- Progreso, 1978?"	Lenin	 Vladimir Ilich
"A Manual of style.-- The University of Chicago Press, 1969"	s/a	
"A Manual of the common invertebrate animals. (Exlusive of insects).-- McGraw-Hill, 1935"	Pratt	 Henry Shering
"A marine turtle : conservation strategy and action plan for the Western Indian Ocean.-- IUCN, 1996"	IUCN East Africa Regional Office and IUCN/ssc marine turtle specialist group	
"A marvelous work and a wonder.-- Deseret book Co., 1950"	Richards	 Le Grand
"A media luz los tres.-- 3a. ed..-- Ediciones Alfil, 1965"	Mihura	 Miguel
"A Modern introduction to basic mathematics.-- Addison-Wesley, c1963"	Keedy	 Mervin Laverne
"A Modern introduction to college mathematics.-- John Wiley, 1959"	Rose	 Israel H.
"A molecular view of heterogeneous catalysis : proceedings of the First Francqui Colloquium, 19-20 february 1996, Brussels.-- DeBoeck Universite, 1998"	s/a	
"A Moveable feast.-- Scribner, 1964"	Hemingway	 Ernest
"A Moveable feast.-- Scribner, 1964"	s/a	
"A Moveable feast.-- Scribner, 1964"	s/a	
"A new introduction to financial accounting.-- Prentice-Hall, 1975"	May	 Robert G.
"A New theory of human evolution.-- Watts, 1948"	Keith	 Arthur
"A new voyage and description of the isthmus of America.-- Cleveland.-- The Burrows brothers company, 1903"	Wafer	 Lionel
"A New voyage to Carolina.-- University Microfilms, 1966"	Lawson	 John
"A Night of Watching.-- Scribner, 1967"	Arnold	 Elliott
"A pathway into number theory.-- Cambridge University Press, 1982"	Burn	 R. P.
"A Pedro Bosch-Gimpera en el septuagésimo aniversario de su nacimiento.-- Instituto Nacional de Antropología e Historia, 1963"	s/a	
"A Picture history of Russia.-- Crown, 1956"	Martin	 John Stuart
"A place called saturday.-- Delacorte press, 1968"	Astor	 Mary
"A place called saturday.-- Delacorte press, 1968"	s/a	
"A preliminary classification of coastal and marine environments.-- IUCN, 1975"	Ray	 G. Carleton
"A preliminary inventory of Coastal Wetlands of Cote d'Ivoire.-- IUCN, 1994"	s/a	
"A propósito del asesinato del presidente Araujo; carta para uno y para muchos.-- Tip. La Unión, 1914"	Leiva	 Nicolás
"-A qué no sabes--? : curso de perfeccionamiento de español para extranjeros.-- Edi-6, 1989"	Miquel López	 Lourdes
"A Range of writing, 1959"	Knepler	 Henry W.    ed.
"A regional action plan for protected areas in east Asia.-- IUCN, 1996"	IUCN Commission on National Parks and Protected Areas	
"A regional geography of Wesstern Europe.-- Longmans, 1960"	Monkhouse	 F. J.
"A Relation of Maryland.-- University Microfilms, 1966"	White	 Andrew
"A report of the IUCN working group on community involvement in forest management.-- IUCN, 1996"	s/a	
"A review of recent knowledge on the relationship between the tsetse hy and its vertebrate hosts.-- IUCN, 1965"	Glover	 P.E.
"A revised handbook to the Flora of Ceylon.-- Amerind Publishing, 1980"	s/a	
"A Rhythmic approach to mathematics.-- The National Council of Teachers of Mathematics, 1975"	Somervell	 Edith L.
"A rosa de cen follas.-- Edicións Xerais de Galicia, 1993"	Cabanillas	 Ramón
"A second course in algebra.-- Macmillan, 1946"	Lennes	 N. J.
"A second course in number theory.-- John Wiley and Sons, 1962"	Cohen	 Harvey
"A short account of the history of mathematics.-- Dover, 1960"	Rouse Ball	 W. W.
"A Short history of American Civilization.-- Holt Rinehart and Winston, 1957"	Savelle	 Max
"A Short history of American Civilization.-- Holt Rinehart and Winston, 1957"	Savelle	 Max
"A short history of Europe since Napoleon.-- John Willey, 1972"	Williams	 Roger Lawrence
"A short history of Europe since Napoleon.-- John Willey, 1972"	s/a	
"A short history of Europe since Napoleon.-- John Willey, 1972"	s/a	
"A short history of France from early times to 1972.-- 2a. ed.-- Cambridge University Press, 1975"	Butterfield	 Herbert
"A Short history of the United States, 1492-1938.-- MacNillan, 1954"	Bassett	 John Spencer
"A socialist empire; the incas of Peru.-- Van Nostrand, 1961"	Baudin	 Louis
"A sourcebook for conservation and biological diversity information.-- IUCN, 1995"	s/a	
"A story of life on the Isthmus.-- G.P. Putnam and co., 1853"	Pabens	 Joseph Warren. 1821-1875
"A strategy for Antarctic conservation.-- IUCN - The World Conservation Union, 1991"	s/a	
"A study of ancient andean social institutions.-- Connecticut academy of arts and sciences, 1925"	Means	 Philip Ainsworth
"A study of smoking habits in El Salvador. Prepared in Abril, 1968 for Cigarrería Morazán.-- International Research Associates., 1968"	International Research Associates	 México.
"A survey of ancient peruvian art.-- Yale University Press, 1917"	Means	 Philip Ainsworth
"A Survey of modern algebra.-- The Macmillan Company, 1964"	Birkhoff	 Garrett
"A survey of primitive money; the beginning of currency.-- Methuen, 1949"	Quiggin	 Alison (Hingston) 1874-
"A Survey of social psychology.-- The Dryden Press, 1975"	Berkowitz	 Leonard
"A system for defining and classifyng natural regions for purposes of conservation.-- IUCN, 1973"	Dasmann	 R.F.
"A systems approach to park planning.-- IUCN, 1966"	Hart	 William J.
"A Textbook of pharmaceutical analysis.-- Wiley, 1967"	Connors	 Kenneth A.
"A thing of beauty.-- Little, Brown, 1956"	Cronin	 A. J.
"A través de mi mente: la educación socialista mexicana.-- Cultura, 1937"	Guzmán	 Solano
"A través del claroscuro : luz y sombra en el dibujo del siglo XVI a l siglo XX.-- Fundación Bancaja, 1996"	Fundación Bancaja	
"A Treatise on the analytical dynamics of particles and rigid bodies : with an introduction to the problem of three bodies.-- 4a. ed.-- Cambridge University Press, 1964"	Whittaker	 Sir Edmund Taylor
"A Treatise on the mathematical theory of elasticity.-- Dover, 1944"	Love	 A. E. H.
"A trova.-- Editora Pongetti, 1973"	Wanke	 Eno Todoro
A un paso del amor	Santacruz	 José Fidel
"A Vida da célula.-- Unión Panamericana, 1968"	Basile	 Renato
"A Vida da célula.-- Unión Panamericana, 1968"	Unión Panamericana. Departamento de Asuntos Científicos	
"A Vida da célula.-- Unión Panamericana, 1968"	s/a	
"A Vida da célula.-- Unión Panamericana, 1968"	s/a	
"A Vida da célula.-- Unión Panamericana, 1968"	s/a	
"A Vida da célula.-- Unión Panamericana, 1968"	s/a	
"A village that chose progress.-- University of chicago Press, 1950"	Redfield	 Robert
"A village that chose progress.-- University of chicago Press, 1950"	s/a	
"A Violencia no esporte.-- Imprensa Oficial Do Estado, 1996"	s/a	
"A Vision of hope : the fiftieth anniversary of the United Nations.-- The Regency Corporation Ltd., 1995"	s/a	
"A Visit to Texas.-- University Microfilms, 1966"	s/a	
"A voyage to South America, describing at large, the spanish cities, towns, provinces on that extenfive continent.-- Lockyer Davis, 1772"	Ulloa	 george Juan de
"A voyage to South America, describing at large, the spanish cities, towns, provinces on that extenfive continent.-- Lockyer Davis, 1772"	s/a	
"A way of life and selected writings, 12 July 1849 to 29 December 1919.-- Dover, 1951"	Osler	 Sir William
"A wayfarer in the West Indies.-- Methuen and co. ltd., 1928"	Aspinall	 Algernon Edward
"A Winter in the west.-- University Microfilms, 1966"	Hoffman	 Charles Fenno
"A Winter in the west.-- University Microfilms, 1966"	s/a	
"A working system for classification of world vegetation.-- IUCN, 1973"	s/a	
"A world of nuclear powers?.-- Prentice-Hall, 1966"	American Assembly	
"A World to unite.-- Palm Publishers, 1971"	s/a	
"A Writer's notebook.-- Doubleday, 1949"	Maugham	 W. Somerset
"A writing apprenticeship.-- Rinehart and Winston, 1963"	Brittin	 Norman A.
"A Yanqui in Patagonia.-- Stanford University press, 1947"	Willis	 Bailey
"A.L.A. rules for filing catalog cards.-- A.L.A., 1942"	American Library Association	
"A.L.A. rules for filing catalog cards.-- A.L.A., 1942"	s/a	
"A.M.D.G. : la vida en los colegios de jesuitas.-- 2a. ed..-- Ediciones Cátedra, 1983"	Pérez de Ayala	 Ramón
"AA llega a su mayor edad : breve historia de AA.-- 5a. ed..-- Oficina de Servicio General de AA, 1996"	s/a	
"AA llega a su mayor edad : breve historia de AA.-- 5a. ed..-- Oficina de Servicio General de AA, 1996"	s/a	
"Abaddón, el exterminador.-- Sudamericana, 1977"	Sabato	 Ernesto
"Abnormal phychology, current perspectives.-- 2d. ed.-- Random House, 1977"	Calhoun	 James F.
"Abnormal psychology current perspectives.-- CRM Books, 1972"	Burret	 Curtis L.
"Abonos : guía práctica de la fertilización.-- 7a. ed..-- Ediciones Mundi-Prensa, 1981"	Gros	 André
"Aboriginal american authors and their product: productions; especially those in the native languages.-- D.G. Brinton, 1883"	Brinton	 Daniel G.
"Aborigines of  South America.-- Chapman and Hall. ltd., 1912"	Church	 George Earl
"Aborto : estudio clínico, psicológico, social y jurídico.-- Médica Panamericana, 1973"	Calandra	 dante
"Aborto: ¿Derecho de las mujeres?.-- Ediciones de la Flor, 1973"	Schulder	 Diane
"Aborto: ¿Derecho de las mujeres?.-- Ediciones de la Flor, 1973"	Kennedy	 Florence
"Abraham Lincoln : ensayos.-- Universidad Autónoma de Centro América, 1987"	Lincoln	 Abraham
"Abriendo camino.-- Arte y Literatura, 1977"	Gros	 José
"Absorción de oxígeno por óxidos de titanio en la oscuridad y bajo radiación ultravioleta.-- Universidad de Sevilla, 1969"	Munuera Contreras	 Guillermo
"Abstract art before columbus.-- André Emmerich Gallery, 1957"	Ashton	 Dore
"Abstract cauchyproblems and functional differential equations.-- Pitman advanced, 1981"	s/a	
"Abstract harmonic analysis.-- Academic Press, 1963"	Hewitt	 Edwin
"Academia Colombiana de Historia; 70 años de su fundación 1902-1972.-- Kelly, 1972"	s/a	
"Acapulco gold.-- warner Paperback Library, 1972"	Corley	 Edwin
"Acceso a la justicia en Centroamérica y Panamá : justicia constitucional.-- PNUD, 2000"	Programa de las Naciones Unidas para el Desarrollo PNUD	
"Acceso a la justicia en Centroamérica y Panamá : justicia constitucional.-- PNUD, 2000"	s/a	
"Acceso a la justicia en Centroamérica y Panamá : población privada de libertad.-- PNUD, 2000"	Programa de las Naciones Unidas para el Desarrollo PNUD	
"Acceso a la justicia en Centroamérica y Panamá : población privada de libertad.-- PNUD, 2000"	s/a	
"Acceso a la justicia en Centroamérica y Panamá : seguridad jurídica e inversiones.-- PNUD, 2000"	Programa de las Naciones Unidas para el Desarrollo PNUD	
"Acceso a la justicia en Centroamérica y Panamá : seguridad jurídica e inversiones.-- PNUD, 2000"	s/a	
"Acceso en linea a bases de datos.-- Instituto Centroamericano de Investigaciones y Tecnología Industrial, 1986"	OEA-ICAITI	
"Access Fácil.-- Prentice-Hall Hispanoamericana, 1995"	McFedries	 Paul
"Access to genetic resources.-- IUCN, 1997"	Mugabe	 John
"Accidentes del trabajo.-- Compañía Argentina de Editores, 1939"	Pozzo	 Juan D.
"Accidentes laborales e incidencia de infección por VIH y hepatitis B y C en una institución mexicana.-- División de Epidemiología Hospitalaria Instituto Nacional de la Nutrición Salvador Zubirais, 1995"	División de Epidemiología Hospitalaria. Instituto Nacional de la Nutrición Salvador Zubirán	
"Acción e ideología : psicología social desde Centroamérica.-- 9a. ed..-- UCA Editores, 1999"	Martín Baró	 Ignacio
"Acción e ideología : psicología social desde Centroamérica.-- 9a. ed..-- UCA Editores, 1999"	s/a	
"Acción y pensamiento económicos de América Latina.-- Palacio del Libro, 1961"	Vásquez Varini	 Felipe S.
"Acción y utopía del hombre de las dificultades.-- Casa de las Américas, 1977"	Acosta Saignes	 Miguel
"Acción, pensamiento y lenguaje.-- 1a. ed..-- Alianza Editorial, 1984"	Bruner	 Jerome
"Acción, pensamiento y lenguaje.-- 1a. ed..-- Alianza Editorial, 1984"	s/a	
"Acciones criminales de los comunistas chinos para narcotizar al mundo.-- Liga Anticomunista, 1976"	Chang	 Tse-Min
"Acciones criminales de los comunistas chinos para narcotizar al mundo.-- Liga Anticomunista, 1976"	s/a	
"Acclimatization in the Andes, historical confirmations of ""climatic aggression in the development on andean man.-- The Johns Hopkina Press, 1948"	Monge	 Carlos
"Account of an expedition from Pittsburg to the Rocky mountains, performed in the years 1819 and ´20, by order of the Hon J.C. Calhoun, sec´y of war: under the command of Major Stephen H. Long. From the notes Major Long, Mr. T. Say, and  the gentlement of the exploring party.-- H.C. Carey and I. Lea, 1822-1823"	James	 Edwin
"Account of an expedition from Pittsburg to the Rocky mountains, performed in the years 1819 and ´20, by order of the Hon J.C. Calhoun, sec´y of war: under the command of Major Stephen H. Long. From the notes Major Long, Mr. T. Say, and  the gentlement of the exploring party.-- H.C. Carey and I. Lea, 1822-1823"	s/a	
"Account of an expedition from Pittsburgh to the Rocky Mountains.-- University Microfilms, 1966"	James	 Edwin
"Account of an expedition from Pittsburgh to the Rocky Mountains.-- University Microfilms, 1966"	s/a	
"Accountants' handbook.-- The Ronald Press, 1965"	Wixon	 Rufus
"Accounting : a systems approach.-- McGraw-Hill Ryerson, 1976"	Kaluza	 Henry J.
"Accounting : concepts and uses.-- Allyn and Bacon, 1969"	Schattke	 Rudolph Walter
"Accounting a programmed text.-- Richard D. Irwin, 1970"	Edwards	 James Don
"Accounting an introduction. Pacific Palisades.-- Goodyear, 1975"	Woelfel	 Charles J.
"Accounting for business.-- Charles E. Merrill, 1968"	Cerepak	 John R.
"Accounting for management control : an introduction.-- 2d. ed.-- Prentice-Hall, 1970"	Horngren	 Charles T.
"Accounting for management control: an introduction.-- Prentice-Hall, 1965"	Horngren	 Charles T.
"Accounting for managerial analysis.-- 3d. ed.-- Richard D. Irwin, 1976"	Fremgen	 James M.
"Accounting in business decisions : theory, method and use.-- Prentice Hall, 1967"	Black	 Homer A.
"Accounting in business decisions : theory, method and use.-- Prentice-Hall, 1962"	Black	 Homer Augustus
"Accounting principles.-- 4th. ed..-- Irwin, 1989"	Hermanson	 Roger H.
"Accounting principles.-- 4th. ed..-- Irwin, 1989"	Edwards	 James Don.
"Accounting principles.-- 4th. ed..-- Irwin, 1989"	Salmonson	 R. F.
"Accounting principles.-- Gage Educational, 1975"	Niswonge	 C. Rollin
"Accounting principles.-- Publishing limited, 1982"	Parker	 John R. E.
"Accounting systems.-- Prentice-Hall, 1963"	Gillespie	 Cecil
"Accounting the basic for busines decisiones.-- McGraw-Hill Ryerson, 1976"	Meigs	 Walter B.
"Accounting theory.-- 3a. ed.-- Richard D. Irwin, 1977"	Hendriksen	 Eldon S.
"Accounting theory.-- Richard D. Irwin, Inc., 1970"	Hendriksen	 Eldon S.
"Accounting, an introduction.-- McGraw-Hill, 1971"	Perry	 Kenneth W.
"Aceleradores de partículas.-- Secretaría General de la OEA, 1982"	Alba Andrade	 Fernando
"Aceleradores de partículas.-- Secretaría General de la OEA, 1982"	s/a	
"Aceleradores de partículas.-- Secretaría General de la OEA, 1982"	s/a	
"Aceleradores de partículas.-- Secretaría General de la OEA, 1982"	s/a	
"Acerca de la incorporación de las masas a la administración del estado.-- Progreso, 1978"	Lenin	 Vladimir Ilich
"Acerca de la incorporación de las masas a la administración del estado.-- Progreso, 1978"	s/a	
"Acerca de la llamada cuestión de los mercados.-- Progreso, [19..]"	Lenin	 Vladimir Ilich
"Acerca de la política exterior del Estado Soviético.-- Progreso, [19..]"	Lenin	 Vladimir Ilich
"Acolman; official guide.-- INAH, s.f."	México. Instituto Nacional de Antropología e Historia	
"Acondicionamiento de aguas para la industria.-- Centro Regional de Ayuda Técnica, 1965"	Powell	 Sheppard T.
"Acondicionamiento de aguas para la industria.-- Centro Regional de Ayuda Técnica, 1965"	s/a	
"Acondicionamiento de aguas para la industria.-- Centro Regional de Ayuda Técnica, 1965"	s/a	
"Acondicionamiento de aguas para la industria.-- Centro Regional de Ayuda Técnica, 1965"	s/a	
"Acondicionamiento de aguas para la industria.-- Centro Regional de Ayuda Técnica, 1965"	s/a	
"Acondicionamiento de aguas para la industria.-- Centro Regional de Ayuda Técnica, 1965"	s/a	
"Acondicionamiento de aguas para la industria.-- Centro Regional de Ayuda Técnica, 1965"	s/a	
"Acondicionamiento de aguas para la industria.-- Centro Regional de Ayuda Técnica, 1965"	s/a	
"Acontecimiento bibliográfico (en torno de la obra ""La Unión de Centro América""del licenciado Alberto Herrarte.-- Editorial del Ministerio de Educación Pública, 1956"	s/a	
"Acontecimiento bibliográfico (en torno de la obra ""La Unión de Centro América""del licenciado Alberto Herrarte.-- Editorial del Ministerio de Educación Pública, 1956"	Bonilla Ruano	 José María
"Acotaciones para la historia de un libro (El puntero apuntado con apuntes breves).-- Ministerio de Educación Pública ""José de Pineda Ibarra"", 1960"	Reyes M.	 José Luis
"Acquisition Work: prosesses involved in building library collections.-- University of Washinton Press, 1961"	Wulfekoetter	 Gertrude
"Across America and Asia; notes of a five years journey around the world, and of residence in Arizona, Japan and China.-- 4th ed. rev..-- Leypoldt and Holt, 1870"	Pumpelly	 Raphael
"Across South America; an account of a journey from Buenos Aires to Lima by way of Potosí, with notes on Brazil, Argentina, Bolivia, Chile, and Peru.-- Houghton Mifflin company, 1911"	Bingham	 Hiram
"Across the Andes.-- Outing publishing company, 1912"	Post	 Charles Johson
"Across the continent.-- University Microfilms, 1966"	Bowles	 Samuel
"Across the great southwestern.-- University Microfilms, 1966"	Kendall	 George W.
"Across the great southwestern.-- University Microfilms, 1966"	s/a	
"Across the Gulf; a narration of a short journey through parts of yucatan, with a brief account of the ancient Maya civilization.-- the Alderbrink press, c1928"	Seymour	 Ralph Fletcher
"Acta de declaración de la independencia.-- Concejo provincial, 1971"	s/a	
"Actas de la Junta Provisional Consultiva, 17 de sep. de 1821-21 de feb. de 1822.-- Ejército, 1971"	s/a	
"Actas de la Reunión Centroamericana sobre Manejo de Recursos Naturales y Culturales.-- IUCN, 1976"	Reunión Centroamericana sobre Manejo de Recursos Naturales y Culturales	1974
"Actas de la sesión especial de trabajo de la Conferencia de las Partes.-- IUCN, 1978"	Convención sobre el Comercio Internacional de Especies Amenazadas de Fauna y Flora Silvestres (1977 : Ginebra	 Suiza)
"Actas de la Sociedad Antropológica de la Isla de Cuba.-- Mario Reguera Gómez, 1966"	Comisión Nacional Cubana de la UNESCO	
"Actas del cabildo eclesiástico de Caracas. Compendio cronológica.-- Fuentes para la Historia Colonial de Venezuela, 1963"	Academia Nacional de la Historia de Venezuela	
"Actas del I simposio de literatura española.-- Ediciones Universidad de Salamanca, 1981"	Simposio de literatura española	 1o.
"Actas del I simposio inetrnacional de mudejarismo.-- Consejo  Superior de Investigaciones Cientificas, 1981"	Consejo Superior de Investigaciones Científicas	
"Actas del I Simposio Internacional de Mudejarismo  : [Ter 15-17 septiembre 1975].-- Consejo Superior de Investigaciones Científicas, 1981"	Consejo Superior de Investigaciones Científicas. España	
"Actas del I Simposio Internacional de Mudejarismo  : [Ter 15-17 septiembre 1975].-- Consejo Superior de Investigaciones Científicas, 1981"	s/a	
"Actas del Octavo Congreso Científico Americano, verificado en la ciudad de Washington del 10 al 18 de Mayo 1940.-- Secretaría de Estado, 1941"	Congreso Científico Americano (8°	 Whasington
"Actas del primer congreso de universidades latinoamericanas : (15 de septiembre de 1949).-- Imprenta Universitaria, 1959"	Universidad de San Carlos de Guatemala	
"Action plan for ""the future of the alps"".-- Italian Alpine Club : IUCN, 1974"	Italian Alpine Club	
"Action plan for african primate conservation: 1986-90.-- IUCN, 1986"	IUCN/SST primate specialist group	
"Action plan for Asian primate conservation: 1987-91.-- IUCN, 1987"	IUCN/SSC primate specialist group	
"Action strategy for protected areas in the afrotropical realm.-- IUCN, 1987"	s/a		
"Activacion analysis handbook.-- Academic Press, 1960"	Koch	 Robert C.	
"Actividad óptica, dispersión rotatoria óptica y dicroismo circular en química orgánica.-- Secretaría General de la OEA, 1981"	Crabb	 Pierre	
"Actividad óptica, dispersión rotatoria óptica y dicroismo circular en química orgánica.-- Secretaría General de la OEA, 1981"	s/a		
"Actividad óptica, dispersión rotatoria óptica y dicroismo circular en química orgánica.-- Secretaría General de la OEA, 1981"	s/a		
"Actividad óptica, dispersión rotatoria óptica y dicroismo circular en química orgánica.-- Secretaría General de la OEA, 1981"	s/a		
"Actividad óptica, dispersión rotatoria óptica y dicroismo circular en química orgánica.-- Secretaría General de la OEA, 1981"	s/a		
"Actividad, conciencia y personalidad.-- Cartago, 1984"	Leontiev	 A. N.	
"Actividades arqueológicas desarrolladas en Copán por... Informes del doctor Gustavo Stromsvick.-- ""Ariston"", 1946"	Conferencia Internacional de Arqueólogos del Caribe	 1a.	1946
"Actividades comunicativas (entre bromas y veras...).-- Edelsa, 1991"	Domínguez González	 Pablo 	
"Actividades comunicativas (entre bromas y veras...).-- Edelsa, 1991"	Bazo Martínez	 Pl cido	
"Actividades de orientación en la escuela primaria.-- Limusa, 1974"	Hatch	 Raymond N.	
"Actividades linguísticas para el período de trabajo independiente.-- UTEHA, 1968"	Willcox	 Isobel	
"Actividades para la enseñanza escolar de la religión.-- PPC, 1992"	Crespo Marco	 Valero	
"Activos fijos, inversiones de carácter permanente.-- Herrero, 1972"	Dyckman	 Thomas R.	
"Acto y Ser.-- Luis Miracle, 1961"	Sciacca	 Michele Federico	
"Acto y Ser.-- Luis Miracle, 1961"	s/a	
"Actopan.-- Instituto Nacional de Antropología e Historia, 1955"	Mac Gregor	 Luis
"Actos de significado : más allá de la revolución cognitiva.-- Alianza Editorial, 1991"	Bruner	 Jerome Seymour
"Actuación del medico ante la violación de los derechos humanos.-- Comisión Nacional de los Derechos Humanos, 1992"	Comisión Nacional de los Derechos Humanos	
"Actuación teatral : guía práctica de todas las fases del teatro.-- Pax-México, 1962"	Tompkins	 Dorothy Lee
"Actuación teatral : guía práctica de todas las fases del teatro.-- Pax-México, 1962"	s/a	
"Actual panorama económico agrícola de El Salvador.-- Ministerio de Agricultura y Ganadería, s.f."	Choussy	 Félix
"Actual panorama económico agrícola de El Salvador.-- Ministerio de Agricultura y Ganadería, s.f."	s/a	
"Actualidad del Ché.-- Ediciones Libertarias, 1999"	s/a	
"Actualidad del Ché.-- Ediciones Libertarias, 1999"	s/a	
"Actualidad del Ché.-- Ediciones Libertarias, 1999"	s/a	
"Acuacultura : diseño y construcción de sistemas.-- AGT Editor, 1977"	Wheaton	 Fredrick W.
"Acuerdo regional sobre el movimiento transfronterizo de desechos peligrosos.-- Gobiernos de Centroamérica, 1992"	Gobiernos de Centroamérica	
"Acuerdos de El Salvador: en el camino de la paz.-- ONU, 1992"	Naciones Unidas	
"Acuerdos de El Salvador: en el camino de la paz.-- ONU, 1992"	s/a	
"Acuerdos de El Salvador: en el camino de la paz.-- ONU, 1992"	s/a	
"Acuerdos de El Salvador: en el camino de la paz.-- ONU, 1992"	s/a	
"Acuerdos de El Salvador: en el camino de la paz.-- ONU, 1992"	s/a	
"Acuerdos de El Salvador: en el camino de la paz.-- ONU, 1992"	s/a	
"Acuerdos ejecutivos e investigaciones de operaciones.-- Herrero, 1965"	Miller	 David Wondell
"Acuerdos ejecutivos e investigaciones de operaciones.-- Herrero, 1965"	Starr	 Martin K.
"Acuerdos internacionales de integración y comercio.-- s.e., 1970"	Instituto Italo-Latino Americano	
"Acuerdos internacionales de los presidentes norteamericanos : el congreso se enfrenta al poder ejecutivo.-- Grupo Editor Latinoamericano, 1986"	Johnson	 Lech K.
"Acuerdos internacionales de los presidentes norteamericanos : el congreso se enfrenta al poder ejecutivo.-- Grupo Editor Latinoamericano, 1986"	s/a	
"Acuicultura : principios y prácticas.-- 1a. ed..-- Limusa, [1997]"	Pillay	 T.V.R.
"Acuicultura : principios y prácticas.-- 1a. ed..-- Limusa, [1997]"	s/a	
"Acumulación de capital y empresas transnacionales en Centroamérica.-- Siglo Veintiuno Editores, 1980"	Castillo Rivas	 Donald
"Acumulación originaria y desarrollo del capitalismo en El Salvador.-- 1a. ed..-- EDUCA, 1980"	Menjívar L.	 Rafael
"Acumulación originaria y desarrollo del capitalismo en El Salvador.-- 2a. ed..-- EDUCA, 1995"	Menjivar Larín	 Rafael
"Acumulación originaria y desarrollo del capitalismo en El Salvador.-- 2a. ed..-- EDUCA, 1995"	s/a	
"Acumulación originaria y desarrollo del capitalismo en El Salvador.-- 2a. ed..-- EDUCA, 1995"	s/a	
"Acumulación originaria y desarrollo del capitalismo en El Salvador.-- 2a. ed..-- EDUCA, 1995"	s/a	
"Acumulación originaria y desarrollo del capitalismo en El Salvador.-- 2a. ed..-- EDUCA, 1995"	s/a	
"Acusación al imperialismo.-- Fondo de Cultura Económica, 1975"	Vuskovic	 Pedro
"Achaques y manías de la sociología moderna y ciencias afines.-- Aguilar, 1957"	Sorokin	 Pitirim Aleksandrovich
"Achaques y manías de la sociología moderna y ciencias afines.-- Aguilar, 1957"	s/a	
"Achaques y manías de la sociología moderna y ciencias afines.-- Aguilar, 1957"	s/a	
"Achaques y manías de la sociología moderna y ciencias afines.-- Aguilar, 1957"	s/a	
"Achaques y manías de la sociología moderna y ciencias afines.-- Aguilar, 1957"	s/a	
"Adam Smith today; an inquiry into the nature and causes of the wealth of nations.-- Richard R. Smith, 1948"	Jenkins	 Arthur Hugh
"Adam's ancestors; an up-to-date outline of the old stone age (Palaeolithic) and what is known about man's origin and evolution.-- 4a. ed. completely rewritten.-- Methuen, 1953"	Leakey	 Louis Seymour Bazett
"Adán Buenosayas.-- 4a. ed.-- Sudamericana, 1976"	Marechal	 Leopoldo
"Adán Buenosayas.-- 4a. ed.-- Sudamericana, 1976"	s/a	
"Adaptación animal.-- Compañía Editorial Continental, 1965"	Burnett	 A. L.
"Adaptación animal.-- Compañía Editorial Continental, 1965"	s/a	
"Adaptation and origin in the plant world.-- The Chronica Botanica Company, 1950"	Clements	 F. E.
"Addenda de ciencia de la administración.-- Universidad Nacional de Educación a Distancia, 1996"	Olmeda Gómez	 José Antonio
"Addendum-corrigendum to the second edition of the United Nations list of national parks and equivalent reserves.-- IUCN, 1972"	s/a	
"Addio a la mamma.-- Casa de las Américas, 1967"	Jitrik	 Noé
"Addresses and statements by the Honorable Cordell Hull, secretary of state of the United States of America, in connection with his trip to South America, 1933-1934, to attend the seventh international conference of American states, Montevideo Uruguay.-- U.S. Govt. print. off., 1935"	Hull	 Cordell
"Adelante. Etapas del desarrollo económico, social y cultural.-- Marymar, 1968"	Barrenechea	 Mauro
"Adeles and algebraic groups.-- Birkhauser, 1982"	Weil	 André
"Adhesión de polímeros y elastómeros mediante adhesivos de contacto.-- Universidad de Alicante, 1993"	Martín Martínez	 J. M.
"Adiestramiento y supervisión de vendedores.-- Herrero, 1961"	Lapp	 Charles L.
"Adiestramiento y supervisión de vendedores.-- Herrero, 1961"	s/a	
"Adiós a Berlín.-- Seix Barral, 1967"	Isherwood	 Christopher
"Adiós a la publicidad.-- Omega, 1996"	Toscani	 Oliviero
"Adiós a la razón.-- 3a. ed..-- Tecnos, 1996"	Feyerabend	 Paul
"Adios a las armas.-- Luis de Caralt, 1960"	Hemingway	 Ernest
"Adiós a Moscú.-- Pomaire, 1977"	Feifer	 George
"Adios a Saigón.-- Amecé, 1976"	Lartéguy	 Jean
"Adios Job.-- Fondo de Cultura Económica, 1961"	Dolujanoff	 Emma
"Adire y el tiempo roto.-- Casa de las Américas, 1967"	Granados	 Manuel
"Administación de de la Investigación científica y Fondo Colomiano de Investigaciones Científicas y Proyectos especiales Francisco José de Caldas.-- Instituto de Integración Cultural, 1969"	Seminario sobre Administración de Investigaciones Científicas (Medellín	 1969)
"Administración : teoría y práctica.-- Prentice-Hall Hispanoamerica, 1984"	Robbins	 Stephen P.
"Administración : una perspectiva global.-- 11a. ed..-- McGraw-Hill, 1998"	Koontz	 Harold
"Administración : una perspectiva global.-- 11a. ed..-- McGraw-Hill, 1998"	Weihrich	 Heinz
"Administración bancaria.-- El Ateneo, 1984"	Crosse	 Howard D.
"Administración bancaria.-- El Ateneo, 1984"	Hempel	 George H.
"Administración colonial española 1782-1810: el sistema de intendencias en el virreinato del Río de La Plata.-- EUDEBA, 1962"	Lynch	 John
"Administración contemporánea.-- McGraw-Hill, 1983"	Hampton	 David R.
"Administración de empresas : teoría y práctica.-- Editorial Limusa S.A., 1997"	Reyes Ponce	 Agustín
"Administración de empresas : teoría y práctica.-- Editorial Limusa, 1989"	Reyes Ponce	 Agustín
"Administración de empresas : teoría y práctica.-- Limusa, 1983"	Reyes Ponce	 Agustín
"Administración de empresas : teoría y práctica.-- Limusa, 1983"	s/a	
"Administración de empresas : teoría y práctica.-- Limusa, 1983"	s/a	
"Administración de empresas : teoría y práctica.-- Limusa, 1983"	s/a	
"Administración de empresas : teoría y práctica.-- Limusa, 1983"	s/a	
"Administración de empresas : teoría y práctica.-- Limusa, 1983"	s/a	
"Administración de empresas en la era electrónica.-- Letras, 1960"	Simon	 Herbert Alexander
"Administración de empresas en la era electrónica.-- Letras, 1960"	s/a	
"Administración de empresas internacionales.-- Continental, 1970"	Robinson	 Richard D.
"Administración de finanzas internacionales.-- Diana, 1973"	Zenoff	 David B.
"Administración de finanzas internacionales.-- Diana, 1973"	Zwick	 Jack
"Administración de fincas cafetaleras, 1988"	Instituto Salvadoreño de Investigaciones del Café ISIC	
"Administración de instituciones educativas : desde la perspectiva del P.E.I..-- 1a.ed.-- Cooperativa Editorial Magisterio, 1995"	Peñate Montes	 Luzardo R.
"Administración de la energía.-- 2a. ed..-- EDUCA, 1988"	Selva T.	 Guillermo
"Administración de la energía.-- 2a. ed..-- EDUCA, 1988"	Umaña	 Alvaro
"Administración de la energía.-- 2a. ed..-- EDUCA, 1988"	s/a	
"Administración de las finanzas municipales.-- Continental, 1962"	International City Manager's Association	
"Administración de mercadeo : estrategias y programas.-- McGraw-Hill, 1984"	Guiltinan	 Joseph P.
"Administración de mercadotecnia : un enfoque desde el punto de vista de los sistemas de conducta.-- Diana, 1971"	Field	 George Albert
"Administración de negocios pequeños: guía para coordinadores de capacitación..-- Trillas, 1973"	Agencia para el Desarrollo de Ayuda Técnica (A.I.D.)	
"Administración de negocios pequeños: guía para coordinadores de capacitación..-- Trillas, 1973"	Centro Regional de Ayuda Técnica	
"Administración de negocios pequeños: guía para instructores : llaves para el éxito.-- Trillas, 1973"	Centro Regional de Ayuda Técnica	
"Administración de negocios pequeños: Guía para la organización y planeación de un curso breve : llaves para el éxito.-- Trillas, 1973"	Centro Regional de Ayuda Técnica	
"Administración de negocios pequeños: Guía para la organización y planeación de un curso breve : llaves para el éxito.-- Trillas, 1973"	Agencia para el Desarrollo Internacional (A.I.D.)	
"Administración de negocios.-- P. Fernández, 1963"	Zapico Medina	 Ramón
"Administración de operaciones : la administración de sistemas productivos.-- Limusa, 1981"	Buffa	 Elwood
"Administración de operaciones.-- Limusa, 1986"	Meredith	 Jack R.
"Administración de operaciones.-- Limusa, 1986"	Gibbs	 Thomas E.
"Administración de personal : un enfoque de sistemas aplicado a recursos humanos.-- Continental, 1987"	Burack	 Elmer H.
"Administración de personal : un enfoque de sistemas aplicado a recursos humanos.-- Continental, 1987"	Smith	 Robert D.
"Administración de personal y sus recursos humanos.-- 3a ed..-- McGraw-Hill, 1991"	Werther	 William B.
"Administración de personal.-- 4a. ed..-- Prentice-Hall Hispanoamericana, 1991"	Dessler	 Gary
"Administración de personal.-- 4a. ed..-- Prentice-Hall Hispanoamericana, 1991"	s/a	
"Administración de personal.-- 8a. ed..-- Pearson Educaciónde México, 2001"	s/a	
"Administración de personal.-- 8a. ed..-- Pearson Educaciónde México, 2001"	Dessler	 Gary
"Administración de personal.-- 8a. ed..-- Pearson Educaciónde México, 2001"	Dessler	 Gary
"Administración de personal.-- Iberoamericana, c1986"	Hernández y Rodríguez	 Sergio Jorge
"Administración de personal.-- Iberoamericana, c1986"	s/a	
"Administración de personal.-- Iberoamericana, c1986"	s/a	
"Administración de personal.-- Iberoamericana, c1986"	s/a	
"Administración de personal.-- Limusa, 1976"	Reyes Ponce	 Agustín
"Administración de personal.-- Limusa, 1976"	s/a	
"Administración de personal.-- Limusa, 1976"	s/a	
"Administración de personal.-- Limusa, 1976"	s/a	
"Administración de personal.-- Limusa, 1976"	s/a	
"Administración de personal.-- Limusa, 1976"	s/a	
"Administración de personal.-- Limusa, 1976"	s/a	
"Administración de personal.-- Limusa, 1976"	s/a	
"Administración de personal.-- Limusa, 1991"	Sikula	 Andrew F.
"Administración de producción y operaciones : manufactura y servicios.-- 8a. ed..-- McGraw-Hill, 2000"	Chase	 Richard B.
"Administración de producción y operaciones, planeación, análisis y control.-- Continental, 1987"	s/a	
"Administración de producción y operaciones, planeación, análisis y control.-- Continental, 1987"	s/a	
"Administración de producción y operaciones, planeación, análisis y control.-- Continental, 1987"	Hopeman	 Richard J.
"Administración de producción y operaciones, planeación, análisis y control.-- Continental, 1987"	s/a	
"Administración de programas de educación temprana y preescolar.-- Trillas, 1987"	Stevens	 Joseph H.
"Administración de programas de educación temprana y preescolar.-- Trillas, 1987"	s/a	
"Administración de recursos humanos.-- 2a. ed.-- McGraw-Hill, 19"	s/a	
"Administración de recursos humanos.-- 2a. ed.-- McGraw-Hill, 19"	Chiavenato	 Idalberto
"Administración de recursos humanos.-- Trillas, 1982"	Arias Galicia	 Fernando
"Administración de recursos humanos.-- Trillas, 1982"	s/a	
"Administración de recursos humanos.-- Trillas, 1982"	s/a	
"Administración de recursos humanos.-- Trillas, 1982"	s/a	
"Administración de recursos humanos.-- Trillas, 1983"	s/a	
"Administración de salas.-- Centro Regional de Ayuda Técnica, 1967"	Hospital Research and trust	
"Administración de salas.-- Centro Regional de Ayuda Técnica, 1967"	s/a	
"Administración de salas.-- Centro Regional de Ayuda Técnica, 1967"	s/a	
"Administración de salas.-- Centro Regional de Ayuda Técnica, 1967"	s/a	
"Administración de salas.-- Centro Regional de Ayuda Técnica, 1967"	s/a	
"Administración de salas.-- Centro Regional de Ayuda Técnica, 1967"	s/a	
"Administración de salas.-- Centro Regional de Ayuda Técnica, 1967"	s/a	
"Administración de unidades informativas, concepto e historia.-- Ediciones Trea, 2002"	Díez Carrera	 Carmen
"Administración de ventas : principios y problemas.-- 3a. ed.-- Diana, 1962"	Canfield	 Bertrand R.
"Administración de ventas : principios y problemas.-- 3a. ed.-- Diana, 1962"	s/a	
"Administración de ventas.-- Técnica, 1968"	Truett	 Fred M.
"Administración del sector público.-- Herrero Hnos., 1970"	Rodríguez Reyes	 Alvaro
"Administración del sector público.-- Herrero Hnos., 1970"	s/a	
"Administración dinámica : colección de papeles de Mary Parker Follet.-- Herrero, 1960"	Metcalf	 Henry C.
"Administración estratégica y calidad integral en las instituciones educativas.-- Cooperativa Editorial Magisterio, 1997"	Correa de Molina	 Cecilia
"Administración financiera.-- 7a ed..-- Prentice-Hall, 1989"	Van Horne	 James C.
"Administración financiera.-- 7a ed..-- Prentice-Hall, 1989"	s/a	
"Administración financiera.-- 7a ed..-- Prentice-Hall, 1989"	s/a	
"Administración financiera.-- Continental, 1978"	Johnson	 Robert W.
"Administración financiera.-- Continental, 1978"	s/a	
"Administración hotelera.-- 2a. ed..-- Editorial Trillas, 2003"	Torre	 Francisco de la
"Administración industrial : organización y gerencia.-- s.e., 195-"	Anzures	 Maximino
"Administración industrial y general: coordinación-control-previsión-organización-mando.-- 14a. ed.-- El ATeneo, 1987"	s/a	
"Administración industrial y general: coordinación-control-previsión-organización-mando.-- 14a. ed.-- El ATeneo, 1987"	s/a	
"Administración industrial y general: coordinación-control-previsión-organización-mando.-- 14a. ed.-- El ATeneo, 1987"	Fayol	 Henri
"Administración industrial y general: coordinación-control-previsión-organización-mando.-- 14a. ed.-- El ATeneo, 1987"	Taylor	 Frederick Winslow
"Administración industrial.-- Limusa, 1983"	Pacífico	 Carl R.
"Administración moderna de cooperativas.-- Centro regional de Ayuda Técnica, 1962"	Cooperative League of U.S.A	
"Administración moderna de cooperativas.-- Centro regional de Ayuda Técnica, 1962"	s/a	
"Administración moderna de hoteles y moteles.-- Editorial Trillas, 2002"	Lattin	 Gerald W.
"Administración moderna de hoteles y moteles.-- Trillas, 1975"	Lattin	 Gerald W.
"Administración moderna de hoteles y moteles.-- Trillas, 1975"	s/a	
"Administración por objetivos : nuevo sistema para la dirección.-- Limusa, 1987"	Odiorne	 George S.
"Administración por objetivos.-- Limusa, 1975"	Reyes Ponce	 Agustín
"Administración por objetivos.-- Limusa, 1975"	s/a	
"Administración práctica de bibliotecas públicas.-- Fondo de Cultura Económica, 1970"	Wheeler	 Joseph L.
"Administración práctica de bibliotecas públicas.-- Fondo de Cultura Económica, 1970"	Herbert Goldhor	
"Administración práctica de bibliotecas públicas.-- Fondo de Cultura Económica, 1970"	s/a	
"Administración pública : perspectivas críticas.-- ICAP, 1984"	Flores	 Gilberto
"Administración pública para el desarrollo integral.-- Fondo de Cultura Económica, 1971"	Jiménez Castro	 Wilburg
"Administración pública para el desarrollo integral.-- Fondo de Cultura Económica, 1971"	s/a	
"Administración pública.-- Ediciones de la Universidad de Puerto Rico, 1956"	A.Simon	Herbert
"Administración pública. Ensayos en honor de Paul H. Appleby.-- Herrero, 1967"	Martin	 Roscoe Coleman
"Administración pública. Ensayos en honor de Paul H. Appleby.-- Herrero, 1967"	s/a	
"Administración pública.-- Letras, 1968"	Simon	 Herbert Alexander
"Administración pública.-- Letras, 1968"	s/a	
"Administración pública.-- Letras, 1968"	s/a	
"Administración pública.-- Letras, 1968"	s/a	
"Administración rural en la refora agraria y el desarrollo económico.-- Facultad Nacional de Agronomía, 1963"	Wheeler	 Richard G.
"Administración rural.-- Instituto Interamericano de Ciencias agrícolas, 1962"	Hopkins	 John A.
"Administración y desarrollo de comunidades educativas : hacia un nuevo paradigma de organización escolar.-- 1a.ed.-- Cooperativa Editorial Magisterio, 1995"	Ordóñez Pachón	 Carlos
"Administración y istribución del patrimonio del cabildo de León en el siglo XV: año 1414-1426.-- Universidad de Salamanca, 1986"	Bautista Bautista	 Mateo
"Administración, dirección y supervisión de escuelas.-- Kapelusz, c1975"	Lemus	 Luis Arturo
"Administración.-- 5a. ed..-- Prentice Hall Hispanoamericana, 1996"	Robbins	 Stephen P.
"Administración.-- 6a. ed..-- Prentice Hall Hispanoamericana, 1996"	Stoner	 James A. F.
"Administración.-- 6a. ed..-- Prentice Hall Hispanoamericana, 1996"	Freeman	 R. Edward
"Administración.-- 9a ed..-- Mc-Graw-Hill, 199-"	Koontz	 Harold
"Administración: curso para nuevos gerentes.-- Limusa, 1979"	Scanlan	 Burt K.
"Administrative oofice management.-- South-Western, 1972"	Neuner	 John J. W.
"Admiral of the ocean sea : a life of Christopher Columbus.-- Time Incorporated, 1962"	Morison	 Samuel Eliot
"Admiral of the ocean sea : a life of Christopher Columbus.-- Time Incorporated, 1962"	s/a	
"Admiral of the ocean sea; a life of Christopher Columbus.-- Little Brown and company, 1942"	Morison	 Samuel Eliot
"Admiral of the ocean sea; a life of Christopher Columbus.-- Little, Brown and company, 1942"	Morison	 Samuel Eliot
"Admiral of the ocean sea; a life of Christopher Columbus.-- Little, Brown and company, 1942"	s/a	
"Adolescence, an introduction.-- Wm. C. Brown, 1981"	Santrock	 John W.
"Adolescencia : años de transición.-- Ediciones Pirámide, 1987"	Hopkins	 J. Roy
"Adolescencia marginal e inhalantes.-- Trillas, 1977"	Garza G.	 Fidel de la
"Adolescencia marginal e inhalantes.-- Trillas, 1977"	Mendiola H.	 Iván
"Adolescencia, salud sexual y reproductiva : influencia de los factores socioculturales.-- Fondo de las Naciones Unidas para la Infancia UNICEF, 1999"	Kasische	 Katrin
"Adolescencia, salud sexual y reproductiva : influencia de los factores socioculturales.-- Fondo de las Naciones Unidas para la Infancia UNICEF, 1999"	Morales Carbonell	 Marina
"Adolescencia, salud sexual y reproductiva : influencia de los factores socioculturales.-- Fondo de las Naciones Unidas para la Infancia UNICEF, 1999"	s/a	
"Adolescencia. El adiós a la infancia.-- Paidós, 1986"	Kaplan	 Louise J.
"Adolescencia.-- Limusa, 1976"	Grinder	 Robert E.
"Adolescencia.-- Limusa, 1976"	Grinder	 Robert E.
"Adolescent obstetrics and gynecology.-- Year Book Medical, 1978"	Kreutner	 A. K.K.
"Adolescentes en conflicto : 29 casos reales.-- Pirámide, 1997"	Urra Portillo	 Javier
"Adquisición de alimentos ; curso de estudios.-- Glem, 1975"	Ross	 Lynne Nannen
"Adquisición de alimentos ; curso de estudios.-- Glem, 1975"	Mohr Mchenry	 Roberta
"Adriana Buenos Aires ; última novela mala.-- Ediciones Coregidor, 1974"	Fernández	 Macedonio
"Adsorción física de gases y vapores por carbones.-- Universidad de Alicante, 1990"	Martín Martínez	 J. M.
"Adsorption and chromatography.-- Interscience, 1951"	Cassidy	 Harold Gomes
"Advanced accounting : an organizational approach.-- John Wiley, 1961"	Bedford	 Norton M.
"Advanced Accounting problems.-- 3a. ed.-- Prentice-Hall, 1960"	Kohler	 E. L.
"Advanced accounting.-- 4th. ed.-- South-Western publ., 1968"	Simons	 Harry
"Advanced analytical chemistry.-- McGraw-Hill, 1958"	Maites	 Louis
"Advanced calculus for applications.-- Prentice Hall, 1964"	Hildebrand	 Francisc Begnaud
"Advanced calculus.-- Addison-Wesley, 1959"	Kaplan	 Wilfred
"Advanced calculus.-- Appleton-Century-Crofts, 1961"	Olmsted	 John M. H.
"Advanced calculus.-- Ginn and Company, 1954"	Woods	 F. S.
"Advanced calculus.-- Ginn and Company, c1955"	Taylor	 Angues Ellis
"Advanced calculus.-- John Wiley, c1955"	Brand	 Louis
"Advanced calculus.-- McGraw-Hill, 1939"	Sokolnikoff	 I. S.
"Advanced inorganic chemistry a comprehensive text.-- Interscience Publishers, 1962"	Cotton	 F. Albert
"Advanced mathematics for engineers.-- Cairo University, 1972"	Antone	 T.A.
"Advanced mathematics in physics and engineering.-- McGraw-Hill, 1953"	Bronwell	 Arthur
"Advanced Turbo C.-- Intertext, 1989"	s/a	
"Advanced Turbo C.-- Intertext, 1989"	s/a	
"Advanced Turbo C.-- Intertext, 1989"	Smith	 James T.
"Advances in botanical research.-- Academic Press, 1963"	s/a	
"Advances in comparative physioly and biochemistry.-- Academic Press, 1966"	Lowenstein	 Otto
"Advances in computers.-- Academic Press, 1960"	Alt	 Franz L.
"Advances in chemical physics, 1958-.-- Interscience, 1958"	s/a	
"Advances in chemical physics, 1958-.-- Interscience, 1958"	s/a	
"Advances in chemical physics, 1958-.-- Interscience, 1958"	s/a	
"Advances in chemical physics, 1958-.-- Interscience, 1958"	s/a
"Advances in chemical physics, 1958-.-- Interscience, 1958"	s/a
"Advances in chemical physics, 1958-.-- Interscience, 1958"	s/a
"Advances in chemical physics, 1958-.-- Interscience, 1958"	s/a
"Advances in chemical physics, 1958-.-- Interscience, 1958"	s/a
"Advances in ecological research.-- Academic Press, 1962"	s/a
"Advances in electrochemistry and electrochemical engineering.-- Interscience, 1961"	s/a
"Advances in electrochemistry and electrochemical engineering.-- Interscience, 1961"	s/a
"Advances in electrochemistry and electrochemical engineering.-- Interscience, 1961"	s/a
"Advances in electrochemistry and electrochemical engineering.-- Interscience, 1961"	s/a
"Advances in electrochemistry and electrochemical engineering.-- Interscience, 1961"	s/a
"Advances in electrochemistry and electrochemical engineering.-- Interscience, 1961"	s/a
"Advances in electronics and electron physics.-- Academic Press, 1948"	s/a
"Advances in electronics and electron physics.-- Academic Press, 1948"	s/a
"Advances in electronics and electron physics.-- Academic Press, 1948"	s/a
"Advances in electronics and electron physics.-- Academic Press, 1948"	s/a
"Advances in electronics and electron physics.-- Academic Press, 1948"	s/a	
"Advances in electronics and electron physics.-- Academic Press, 1948"	s/a	
"Advances in electronics and electron physics.-- Academic Press, 1948"	s/a	
"Advances in electronics and electron physics.-- Academic Press, 1948"	s/a	
"Advances in genetics.-- Academic Press, 1947"	s/a	
"Advances in genetics.-- Academic Press, 1947"	s/a	
"Advances in genetics.-- Academic Press, 1947"	s/a	
"Advances in genetics.-- Academic Press, 1947"	s/a	
"Advances in genetics.-- Academic Press, 1947"	s/a	
"Advances in genetics.-- Academic Press, 1947"	s/a	
"Advances in genetics.-- Academic Press, 1947"	s/a	
"Advances in genetics.-- Academic Press, 1947"	s/a	
"Advances in insect physiology.-- Academic Press, 1963"	Beament	 J. W. L.
"Advances in marine biology 1963-.-- Academic Press, s.f."	s/a	
"Advances in marine biology 1963-.-- Academic Press, s.f."	s/a	
"Advances in marine biology 1963-.-- Academic Press, s.f."	s/a	
"Advances in marine biology 1963-.-- Academic Press, s.f."	s/a
"Advances in marine biology 1963-.-- Academic Press, s.f."	s/a
"Advances in photochemistry.-- Interscience, 1963"	s/a
"Advances in photochemistry.-- Interscience, 1963"	s/a
"Advances in photochemistry.-- Interscience, 1963"	s/a
"Advances in photochemistry.-- Interscience, 1963"	s/a
"Advances in photochemistry.-- Interscience, 1963"	s/a
"Advances in photochemistry.-- Interscience, 1963"	s/a
"Advances in photochemistry.-- Interscience, 1963"	s/a
"Advances in photochemistry.-- Interscience, 1963"	s/a
"Advances in physical organic chemistry.-- Academic Press, 1963"	s/a
"Advances in physical organic chemistry.-- Academic Press, 1963"	s/a
"Advances in physical organic chemistry.-- Academic Press, 1963"	s/a
"Advances in physical organic chemistry.-- Academic Press, 1963"	s/a
"Advances in quantum chemistry.-- Academic Press, 1964"	s/a
"Advances in quantum chemistry.-- Academic Press, 1964"	s/a
"Advances in the chemistry of the coordination compouds.-- MacMillan, 1961"	International Conference on Coordination Chemistry (6a.	 Detroit
"Adventure amidst the equatorial forests and rivers of South America; also in the West Indies and the wilds of Florida. To which is added ""Jamaica revisited"".-- J. Murray, 1891"	Stuart	 Villiers
"Adventure in Costa Rica.-- Dixie Pub., 1960"	Lundberg	 Donald E.
"Adventure into the unknown: the first fifty years of the General Electric Research Laboratory.-- William Morrow, 1950"	Hawkins	 Laurence A.
"Adventure south; three men and a lone car blaze the Pan American highway route down two continents to cape Horn.-- Arnold-Powers, inc., 1942"	Richardson	 Sullivan C.
"Adventures in Mexico and the Rocky Mountains.-- Harper and brothers, 1848"	Ruxton	 George Frederick Augustus
"Aerial odysea: Cuba, Haiti, Dominican republic, Porto Rico, Virgin islands, the Lesser Antillas, Trinidad, the Guinas, Venezuela, Colombia, Panama, Costa Rica, Nicaragua, El Salvador, Honduras, Guatemala and Mexico.-- The MacMillan company, 1936"	Powell	 Edward Alexander
"Aerobics; ejercicios aerobicos.-- Diana, 1971"	Cooper	 Kenneth H.
"Aeronaves del futuro.-- Editores asociados, 1978"	White	 William J.
"Afghanistan : a study of political developments in Central and Southern Asia.-- 3 ed.-- Oxford University Press, 1967"	Fraser-Tytler	 Sir William Kerr
"Afinación y temperamento en la música occidental.-- Alianza Editorial, 1992"	Goldáraz Gaínza	 J. Javier
"África : desde la prehistoria hasta los estados actuales.-- 13a. ed. en castellano.-- Siglo XXI, 1991"	Bertaux	 Pierre
"Africa : en busca de una identidad.-- Unión Tipográfica Editorial Hispano Americana, 1967"	Ferkiss	 Víctor C.
"Africa : en busca de una identidad.-- Unión Tipográfica Editorial Hispano Americana, 1967"	s/a	
"Africa and the discovery of America.-- Innes and sons, 1920-22"	Wiener	 Leo
"Africa and the discovery of America.-- Innes and sons, 1920-22"	s/a	
"Africa.-- Celeste, 1995"	Clarke	 Matthew
"Africa: its peoples and their culture history.-- McGraw-Hill, 1959"	Murdock	 George Peter
"African antilope database 1998.-- The World Conservation Union, 1999"	<The> IUCN Species Survival Commission	
"African art.-- University, 1974"	Illinois State University. The Ewing Museum of Nations	
"African elephant database 1998.-- International Union for Conservation of Nature and Natural Resources, 1999"	s/a	
"African elephants and rhinos : status survey and conservation action plan.-- IUCN, 1990"	s/a	
"African insectivora and elephant-shrews : an action plan for their conservation.-- IUCN, 1990"	s/a	
"African rhino.-- IUCN, 1999"	International Union for Conservation of Nature and Natural Resources	
"African wildlife laws.-- IUCN, s.f."	IUCN Environmental Law Center	
"Afrontar el cambio : gente, bosques y biodiversidad.-- IUCN, 1994"	McNeely	 Jeffrey A.
"After Hong Kong: whither Taiwan; : world press perspectives on the Republic of China's future in the wake of the Hong Kong transition.-- 1a. ed..-- Government Information Office, 1998"	s/a	
"After Hong Kong: whither Taiwan; : world press perspectives on the Republic of China's future in the wake of the Hong Kong transition.-- 1a. ed..-- Government Information Office, 1998"	s/a	
"Agenda 2.0 made easy.-- Osborne McGraw-Hill, c1991"	Campbell	 Mary
"Agenda 2.0 made easy.-- Osborne McGraw-Hill, c1991"	s/a	
"Agenda 2.0 made easy.-- Osborne McGraw-Hill, c1991"	s/a	
"Agenda 21: earth's action plan.-- The Commission on Environmental Law of IUCN-The World conservation Union, 19"	s/a	
"Agenda de la postguerra.-- Fondo de cultura Económica, 1944"	Condliffe	 J. B.
"Agenda de la postguerra.-- Fondo de cultura Económica, 1944"	s/a	
"Agenda de la postguerra.-- Fondo de cultura Económica, 1944"	s/a	
"Agenda del organizador.-- 2a. ed.-- Francisco Casanovas, 1960"	Pasdermadjian	 H.
"Agenda del organizador.-- 2a. ed.-- Francisco Casanovas, 1960"	s/a	
"Agenda nacional de concertación para la reactivación del sector agropecuario.-- Ministerio de Agricultura y Ganadería, 1995"	El Salvador. Ministerio de Agricultura y Ganadería	
"Agentes de poder: la influencia de los medios informativos en las relacioneshumanas.-- Publigrafic, 1988, 1988"	Altschull	 J. Herbert
"Agonía y despertar de China : Historia y critica de su pasado y presente. Su significación futura.-- Claridad, 1938"	Suda	 Emanuel
"Agosto, 1914 (10-21 de agosto) nudo I.-- 4a. ed.-- Barral, 1974"	Solzhenitsyn	 Alexander Iseavich
"Agraísmo guatemalteco: sipnosis histórica.-- [s.n.], 1966"	Herrera	 Francisco
"Agrarian reform in latin america.-- Knopf, 1968"	Smith	 Thomas Lynn
"Agregación lineal de relaciones económicas.-- Aguilar, 1959"	Theil	 H
"Agregación lineal de relaciones económicas.-- Aguilar, 1959"	s/a	
"Agregados económicos y política pública.-- Fondo de Cultura Económica, 1963"	Siegel	 Barry N.
"Agregados económicos y política pública.-- Fondo de Cultura Económica, 1963"	s/a	
"Agregados económicos y política pública.-- Fondo de Cultura Económica, 1963"	s/a	
"Agresión desde el espacio : cultura y napalm en la era de los satélites.-- Siglo Veintiuno, 1972"	Mattelart	 Armand
"Agricultura e industrialización.-- Fondo de Cultura Económica, 1951"	Chang	 Pei-Kang
"Agricultura e industrialización.-- Fondo de Cultura Económica, 1951"	s/a	
"Agricultura e industrialización.-- Fondo de Cultura Económica, 1951"	s/a	
"Agricultura e industrialización.-- Fondo de Cultura Económica, 1951"	s/a	
"Agricultura mudnial; el mundo del agricultor.-- Herrero, 1968"	s/a	
"Agricultura sin laboreo ; principios y aplicaciones.-- Bellaterra, 1986"	Phillips	 Ronald E.
"Agricultura sin laboreo ; principios y aplicaciones.-- Bellaterra, 1986"	Phillips	 Shirley H.
"Agricultura y alimentos : el poder de las transnacionales.-- UNAM : ICI, 1985"	Arroyo	 Gonzalo
"Agricultura y civilización en Mesoamérica.-- Secretaría de Educación Pública, 1972"	Palerm	 Angel
"Agricultura y ganadería: competencia por el uso de la tierra.-- Ediciones de Cultura Popular, 1987"	Pérez Espejo	  osario
"Agricultura y medio ambiente en América Latina.-- 1a. ed..-- EDUCA-SIAP, 1986"	Gligo	 Nicolo
"Agricultura y medio ambiente en América Latina.-- 1a. ed..-- EDUCA-SIAP, 1986"	s/a	
"Agricultura y medio ambiente en América Latina.-- 1a. ed..-- EDUCA-SIAP, 1986"	s/a	
"Agricultura y medio ambiente en América Latina.-- 1a. ed..-- EDUCA-SIAP, 1986"	s/a	
"Agricultura y medio ambiente en América Latina.-- 1a. ed..-- EDUCA-SIAP, 1986"	s/a	
"Agricultural and technical journalism.-- Prentice-Hall, 1957"	Fox	 Rodney
"Agricultural origins and dispersals.-- The American Geographical Society, 1952"	Sauer	 Carl Ortwin
"Agroindustria rural: apuntes teórico-metodológicos para su promoción.-- 1a. ed..-- EDUCA, 1988"	s/a	
"Agroindustria rural: apuntes teórico-metodológicos para su promoción.-- 1a. ed..-- EDUCA, 1988"	s/a	
"Agroindustria rural: apuntes teórico-metodológicos para su promoción.-- 1a. ed..-- EDUCA, 1988"	s/a	
"Agroindustria rural: apuntes teórico-metodológicos para su promoción.-- 1a. ed..-- EDUCA, 1988"	s/a	
"Agronomía y agricultura.-- Editorial universitaria, 1956"	Molina LLarden	 Mario
"Agronomía y agricultura.-- Editorial universitaria, 1956"	s/a	
"Agua de Coco..-- s.e., 1961"	Herrera Velado	 Francisco.
"Agua de Coco..-- s.e., 1961"	s/a	
"Agua de Coco..-- s.e., 1961"	s/a	
"Agua de Coco..-- s.e., 1961"	s/a	
"Agua dulce de los salados mares.-- Diana, 1969"	Woodbury	 David O.
"Agua regia (1967-1971).-- EDUCA, 1972"	Morales	 Beltrán
"Agua regia (1967-1971).-- EDUCA, 1972"	s/a	
"Agua y desarrollo en la Comunidad Valenciana.-- Universidad de Alicante, 1998"	Rico Amorós	 Antonio
"Agua y espacios de ocio.-- Universidad de Alicante, 1995"	Bru Ronda	 Concepción
"Agua y espacios de ocio.-- Universidad de Alicante, 1995"	Santafé Martínez	 José Ma.
"Agua y modo de producción.-- Crítica, 1990"	s/a	
"Agua y modo de producción.-- Crítica, 1990"	s/a	
"Agua y salud humana.-- Limusa, 1988"	McJunkin	 F. Eugene
"Aguaceros de vida.-- XYZ Impresores, 1993"	Charría García	 Fernando
"Aguardiente y otros cantares.-- CASA, 1978"	Pérez	 Hildebrando
"Aguas envasadas.-- Editorial Limusa S.A. de C.V., 1999"	Tampo	 Deborah
"Aguas salvadoreñas : capital de trabajo para la nación.-- GOES USAID, 1998"	Michaels	 Greg
"Aguas turbias.-- 3a. ed..-- EUNA, 1995"	Dobles	 Fabián
"Agujeros negros.-- 2a. ed..-- Equipo Sirius, 1993"	Ruíz Morales	 Jorge
"Agujeros negros.-- Alianza Editorial, 1991"	Luminet	 Jean-Pierre
"Agustin de Iturbide y Costa Rica.-- Costa Rica, 1968"	Peralta	 Hernán G.
"Ahorro y préstamo, para la vivienda familiar.-- Fondo de Cultura Económica, 1950"	Lamas	 Adolfo
"Ahorro y préstamo, para la vivienda familiar.-- Fondo de Cultura Económica, 1950"	s/a	
"AI in process control : artificial intelligence technologies.-- Intertext, 1989"	Stock	 Michael
"AI in process control : artificial intelligence technologies.-- Intertext, 1989"	s/a	
"AI in process control : artificial intelligence technologies.-- Intertext, 1989"	s/a	
"AID  y las transformaciones globales en El Salvador : el papel de la política de asistencia económica de los Estados Unidos desde 1980.-- CRIES, 1993"	Rosa	 Herman
"Aimables sauvages.-- Librairie Plon, 1960"	Huxley	 Francis
"Air Pollution : proceedings of the United States Technical Conference on Air Pollution.-- McGraw-Hill, 1952"	McCabe	 Louis
"Air pollution, proceedings of the first European Congress on the influence of air pollution on plants and animals.-- Centr for Agricultural Publishing and Documentation, 1969"	European Congress on the Influence of air pollution on plants and animals	 1 st. Wageningen
"Aires indios.-- Letras, 1947"	Yupanqui	 Atahualpa
"Aires musicales de los indios Guambiano del Cauca (Colombia).-- Imp. Nac., 1970"	Bermudez Silva	 Jesús
"Airport.-- Doubleday, 1968"	Hailey	 Arthur
"Akenatón.-- Edimat Libros, 1998"	Caniff	 Patricia
"Aku-Aku, the secret of Easter Island.-- American ed..-- Rand McNally, 1958"	Heyerdahl	 Thor
"Al acecho del viento: las influencias visibles e invisibles sobre el clima local.-- EUDEBA, 1969"	Edinger	 James G.
"Al azar de los caminos.-- Ministerio de Cultura, 1959"	Darlee	 Frina
"Al azar de los caminos.-- Ministerio de Cultura, 1959"	s/a	
"Al azar de los caminos.-- Ministerio de Cultura, 1959"	s/a	
"Al azar de los caminos.-- Ministerio de Cultura, 1959"	s/a	
"Al azar de los caminos.-- Ministerio de Cultura, 1959"	s/a	
"Al azar de los caminos.-- Ministerio de Cultura, 1959"	s/a	
"Al calor de la lumbre : cuentos.-- Clásicos Roxsil, 2002"	Castillo	 María de los Angeles de
"Al calor de la semilla.-- Bogavante, 1971"	Dalton	 Margarita
"Al encuentro de Averroes.-- Trotta, 1993"	Martínez Lorca	 Andrés
"Al encuentro de nuestro pensamiento jurídico poético 6.-- Centro de Gobierno, 2001"	El Salvador. Corte Suprema de Justicia	
"Al filo del agua.-- Porrúa, 1965"	Yanez	 Agustin
"Al margen de estos clásicos : autores españoles del siglo XX.-- Afrodidisio Aguado, 1967"	Marías	 Julian
"Al margen de la historia universal.-- UTEHA, 1961"	Berr	 Henri
"Al margen de la historia universal.-- UTEHA, 1961"	s/a	
"Al margen de la historia universal.-- UTEHA, 1961"	Berr	 Henri
"Al margen de los clásicos.-- Imprenta Clásica Española, 1915"	Azorín	 seud
"Al Norte del río Bravo (pasado inmediato) (1930-1981).-- Siglo XXI, 1981"	Maciel	 David
"Al otro lado del espejo.-- Dirección General de Publicaciones, 1972"	Juarez	 Salvador Antonio
"alacranes : premio José Rafael Pocaterra 1966.-- Dirección de Cultura Universidad Central de Venezuela, 1968"	Izaguirre	 Rodolfo
"Aladino y la lámpara maravillosa y otros cuentos.-- 2a. ed..-- EDUCA, 1997"	s/a	
"Aladino y la lámpara maravillosa y otros cuentos.-- EDUCA, 1993"	s/a	
"Aladino y la lámpara maravillosa y otros cuentos.-- EDUCA, 1993"	s/a	
"Aladino y la lámpara maravillosa y otros cuentos.-- EDUCA, 1993"	s/a	
"Alajuela de ayer.-- EDUCA, 1985"	Chacón P.	 Nelson
"Alarma; el planeta se calienta : una realidad amenazadora.-- Flor del Viento Ediciones, 2998"	Brown	 Paul
"Alas capitulaciones de indias en el siglo XVI.-- Ediciones Cultura Hispánica, Instituto de Cooperación Iberoamericana, 1986"	Avas milagros	 milagros del
"Alas de tierra : Poesía (1943-1973).-- UNAM, 1975"	Rejano	 Juan
"Alas de tierra : Poesía (1943-1973).-- UNAM, 1975"	s/a	
"Alaska.-- Letras, 1966"	Hilscher	 Herb.
"Alaskan Eskimo ceremonialism.-- J.J. Augustin, 1947"	Lantis	 Margaret
"Albert Einstein : vida, obra y filosofía.-- Alianza Editorial, 1994"	Merleau-Ponty	 Jacques
"Albert Einstein : vida, obra y filosofía.-- Alianza Editorial, 1994"	s/a	
"Album de colecciones arqueológicas.-- Escuela Internacional de Arqueología y Etnología Americanas, 1911-1912"	Boas	 Franz
"Album familiar.-- 2a. ed.-- EDUCA, 1984"	Alegría	 Claribel
"Album familiar.-- 2a. ed.-- EDUCA, 1984"	s/a	
"Album familiar.-- 2a. ed.-- EDUCA, 1984"	s/a	
"Album familiar.-- 2a. ed.-- EDUCA, 1984"	s/a	
"Album familiar.-- 2a. ed.-- EDUCA, 1984"	s/a	
"Album Ráfols-Casamada : veure és sentir.-- 1õ ed..-- Fundació EINA, 1994"	Abrams	 D. Sam
"Alcaldes mayores;historia de los alcaldes mayores,justicias mayores, gobernadores intendnentes,intendentes corregidores y jefes políticos,de la provincia de San Salvador, San Miguel y San Vicente.-- Dirección General de Publicaciones, 1979"	Rubio Sánchez	 Manuel
"Alcaldes mayores;historia de los alcaldes mayores,justicias mayores, gobernadores intendnentes,intendentes corregidores y jefes políticos,de la provincia de San Salvador, San Miguel y San Vicente.-- Dirección General de Publicaciones, 1979"	s/a	
"Alcaldes mayores;historia de los alcaldes mayores,justicias mayores, gobernadores intendnentes,intendentes corregidores y jefes políticos,de la provincia de San Salvador, San Miguel y San Vicente.-- Dirección General de Publicaciones, 1979"	s/a	
"Alcaldes mayores;historia de los alcaldes mayores,justicias mayores, gobernadores intendnentes,intendentes corregidores y jefes políticos,de la provincia de San Salvador, San Miguel y San Vicente.-- Dirección General de Publicaciones, 1979"	s/a	
"Alcaldes mayores;historia de los alcaldes mayores,justicias mayores, gobernadores intendnentes,intendentes corregidores y jefes políticos,de la provincia de San Salvador, San Miguel y San Vicente.-- Dirección General de Publicaciones, 1979"	Rubio Sánchez	 Manuel
"Alcestis, Las Bacantes. El cicloteEl CicloteLas Bacantes.-- Espasa-Calpe, 1972"	Eurípides	 480-406
"Alcohólicos Anónimos : el relato de como muchos miles de hombres y mujeres se han recuperado del alcoholismo.-- Alcoholics Anonymous World Services, 1993"	s/a	
"Alcoholismo en América Latina.-- Palestra, 1961"	Ferrara	 Floreal
"Alcoholismo juvenil : prevención y tratamiento.-- Ediciones Pirámide, 1997"	Secades Villa	 Roberto
"Alegato límites Costa Rica Colombia.-- s.e., 1893"	Peralta	 Manuel María de
"Alejandro de Humboldt : su vida y su obra.-- Ministerio de Educación Pública, 1951"	Alessio Robles	 Vito
"Alejandro de Humboldt.-- Inter Nations, 1969"	Meyer-Abich	 Adolf
"Alejandro de Humboldt.-- Inter Nations, 1969"	s/a	
"Alejandro de Humboldt.-- Inter Nations, 1969"	s/a	
"Alejandro Korn.-- Losada, 1940"	Romero	 Francisco
"Alemania 1945-1954.-- s.e., s.f."	Boas International Publishing	 Co.
"Alemania.-- Offset Multicolor, 1962"	Prittie	 Ilon Terence Cornelius Farmer
"Alemania.-- UNAM, 1960"	Heine	 Enrique
"Alerta mariguana.-- EDAMEX, 1986"	Mann	 Peggy
"Alesio, una comedia de tiempos pasados (o ""Bululu y medio"").-- Ediciones de Cultura Hispánica, Instituto de Cooperación Iberoamericana, 1987"	García May	 Ignacio
"Alesio, una comedia de tiempos pasados (o ""Bululu y medio"").-- Ediciones de Cultura Hispánica, Instituto de Cooperación Iberoamericana, 1987"	s/a	
"Alessandri.-- Fondo de Cultura Económica, 1952"	Donoso	 Ricardo
"Alessandro Manzoni : estudios en el centenario de su muerte, 1873-1973.-- Universidad, 1973"	<La> Plata. Universidad Nacional. Facultad de Humanidades y Ciencias de la Educación	
"Alexander Hamilton.-- Ediciones Monroy Padilla, 1969"	Wise	 William
"Alexander Von Humboldt.-- Deutscher Kunstverlag Munchen Berlin, 1843"	Bitterling	 Richard
"Alfabetización temprana... y después : acerca de la continuidad de la enseñanza de la lectura y la escritura.-- Ediciones Santillana, 1998"	Kaufman	 Ana María
"Alfabetización y postalfabetización por radio.-- Editorial Humanitas, 1992"	s/a	
"Alfabeto para los cuatro idiomas indígenas mayoritarios de Guatemala: quiché, cakchiquel, mam y kekchí.-- Ministerio de Educación Pública, 1950"	Guatemala. Instituto Indigenista Nacional	
"Alfabeto para los cuatro idiomas indígenas mayoritarios de Guatemala: quiché, cakchiquel, mam y kekchí.-- Ministerio de Educación Pública, 1950"	s/a	
"Alfarería poblana.-- Editorial Novaro, 1968"	Academia Mexicana de Arte Popular	
"Alfonso XIII.-- Juventud, 1945"	Baviera	 Pilar de
"Algae, the grass of many waters.-- Charles C. Thomas, 1958"	Tiffany	 Lewis Hanford
"Algebra : con gráficos y 6523 ejercicios y problemas con respuestas.-- Grupo Patria Cultural, 2000"	Baldor	 Aurelio
"Algebra : con gráficos y 6523 ejercicios y problemas con respuestas.-- Grupo Patria Cultural, 2000"	s/a	
"Algebra abstracta.-- Grupo Editorial Iberoamérica, 1988"	Herstein	 I. N.
"Algebra and trigonometry.-- Prentice-Hall, 1964"	Miller	 Irwin
"Algebra and trigonometry.-- Weber and Schmidt, 1980"	Rice	 Bernard J.
"Algebra booleana; instrucción programada.-- Centro Regional de Ayuda Técnica, 1973"	Wolf	 Oswald
"Algebra con aplicaciones.-- Harla, c1983"	Phillips	 Elizabeth Difanis
"Algebra de commutación y circuitos digitales básicos.-- Alhambra, 1974"	Dworatschek	 Sebastian
"Algebra elemental.-- Secretaría General de la OEA, 1986"	Nachbin	 Leopoldo
"Algebra elemental.-- Secretaría General de la OEA, 1986"	s/a	
"Algebra elemental.-- Secretaría General de la OEA, 1986"	s/a	
"Algebra elemental.-- Secretaría General de la OEA, 1986"	s/a	
"Algebra elemental.-- Secretaría General de la OEA, 1986"	s/a	
"Algebra for college students.-- W.B. Saunders Company, 1977"	Bello	 Ignacio
"Algebra intermedia.-- McGraw-Hill, 1964"	Rees	 Paul K.
"Algebra lineal con aplicaciones.-- International Thomson Editores, 1999"	Nakos	 George
"Algebra lineal y programación lineal.-- s.e., s.f."	Acher	 Jean
"Algebra lineal y sus aplicaciones.-- Addison-Wesley Iberoamericana, 1990"	Strang	 Gilbert
"Algebra lineal y teoría de matrices.-- 2a ed..-- Limusa, 1977"	Nering	 Evar D.
"Algebra lineal y teoría de matrices.-- Grupo Editorial Iberoamérica, 1989"	Herstein	 I. N.
"Algebra lineal.-- [3a. ed.].-- Ediciones Pirámide, 1990"	Gutiérrez Gómez	 Andrés
"Algebra lineal.-- 4a. ed.-- Secretaría General de la OEA, 1981"	Villamayor	 Orlando E.
"Algebra lineal.-- 4a. ed.-- Secretaría General de la OEA, 1981"	s/a	
"Algebra lineal.-- 4a. ed.-- Secretaría General de la OEA, 1981"	s/a	
"Algebra lineal.-- 4a. ed.-- Secretaría General de la OEA, 1981"	s/a	
"Algebra lineal.-- 5a. ed..-- McGraw-Hill, 1996"	Grossman	 Stanley I.
"Algebra lineal.-- 5a. ed..-- McGraw-Hill, 1996"	s/a	
"Algebra lineal.-- Addison-Wesley Iberoamericana, c1989"	Fraleigh	 John B.
"Algebra lineal.-- Centro Regional de Ayuda Técnica, 1972"	Mostow	 George C.
"Algebra lineal.-- Fondo Educativo Interamericano, 1969"	Hadley	 G.
"Algebra lineal.-- Fondo Educativo Interamericano, 1969"	s/a	
"Algebra lineal.-- Fondo Educativo Interamericano, 1969"	s/a	
"Algebra lineal.-- Fondo Educativo Interamericano, 1969"	s/a	
"Algebra lineal.-- Fondo Educativo Interamericano, 1969"	s/a	
"Algebra lineal.-- Fondo Educativo Interamericano, 1969"	s/a	
"Algebra lineal.-- Fondo Educativo Interamericano, 1969"	s/a	
"Algebra lineal.-- Prentice-Hall Hispanoamericana, 1973"	Hoffman	 Kenneth
"Algebra lineal.-- Prentice-Hall Hispanoamericana, 1973"	Kunze	 Rey
"Algebra lineal.-- s.n., (1971)"	Lang	 Serge
"Algebra lineal.-- Varicop, s.f."	Pinilla	 José L.
"Algebra y trigonometría con geometría analítica.-- 9a ed..-- International Thomson Editores, 1998"	Swokowski	 Earl W.
"Algebra y trigonometría con geometría analítica.-- 9a ed..-- International Thomson Editores, 1998"	Cole	 Jeffery A.
"Algebra y trigonometría con geometría analítica.-- Grupo Editorial Iberoamericana, 1981"	Swokowski	 Earl W.
"Algebra y trigonometría.-- 2a ed..-- McGraw-Hill, 1998"	Zill	 Dennis G.
"Algebra y trigonometría.-- 2a ed..-- McGraw-Hill, 1998"	Dewar	 Jackeline M.
"Algebra y trigonometría.-- 2a ed..-- McGraw-Hill, 1998"	s/a	
"Algebra.-- 10a ed..-- McGraw Hill, 1991"	Rees	 Paul K.
"Algebra.-- 10a ed..-- McGraw Hill, 1991"	Sparks	 Fred W.
"Algebra.-- Addison-Wesley, 1971"	Lendsey	 Lona Lee
"Algebra.-- Addison-Wesley, 1971"	Johnson	 Richard E.
"Algebra.-- Ediciones Pirámide, 1994"	Abbott	 P.
"Algebra.-- Macmillan, 1967"	Maclane	 Saunders
"Algebraic number theory.-- McGraw-Hill Book Co., 1963"	Weiss	 Edwin
"Algebraic numbers and fourier analysis.-- D. C. Heath, 1963"	Salem	 Raphael
"Algebraic topology.-- McGraw-Hill, 1966"	Spanier	 Edwin H.
"A'lgebras de boole y lógica.-- Publicacions Universitat de Bardelona, 1989"	Jané	 Ignacio
"Algébre gémétrie.-- Gauthier-Villars, 1962"	Artin	 E.
"Algo más que periodistas : sociología de una profesión.-- Editorial Ariel, 2000"	Ortega	 Félix
"Algo sobre Virginia Woolf.-- Universitaria, 1967"	Claro	 María Elena
"Algoritmos y estructuras de datos.-- Prentice-Hall Hipanoamericana, 1987"	With	 Niklaus
"Alguien maulla.-- Fondo de Cultura Económico, 1985"	Quiñones	 Isabel
"Alguien tiene que llorar.-- Ediciones Casa de las Américas, 1995"	Bobes León	 Marilyn
"Algunas consideraciones sobre tenencia de la tierra en relación al desarrollo agropecuario de los países centroamericanos.-- Instituto Universitario Centroamericano de Investigaciones Sociales y Económicas, 1965"	Boaventura	 Francisco T.
"Algunas consideraciones sobre tenencia de la tierra en relación al desarrollo agropecuario de los países centroamericanos.-- Instituto Universitario Centroamericano de Investigaciones Sociales y Económicas, 1965"	s/a	
"Algunas consideraciones sobre tenencia de la tierra en relación al desarrollo agropecuario de los países centroamericanos.-- Instituto Universitario Centroamericano de Investigaciones Sociales y Económicas, 1965"	s/a	
"Algunas cuestiones de ordenación del territorio.-- Universidad de Alicante, 1993"	s/a	
"Algunas cuestiones de ordenación del territorio.-- Universidad de Alicante, 1993"	s/a	
"Algunas cuestiones sobre ordenación del territorio.-- Universidad de Alicante. Instituto Universitario de Geografía, 1993"	Gil Olcina	 Antonio
"Algunas lecciones de cálculo (análisis matemático en una variable.-- s.e, s.f."	García Alfonsa	
"Algunas normas generalmente aceptadas para la preparación de trabajos científicos.-- Trejos Hnos., 1953"	Trejos	 Alfonso
"Algunas nubes.-- Leega Literaria, 1985"	Taibo II	 Paco Ignacio
"Algunas ruinas prehispánicas en Quintana Roo.-- Artes Gráficas del Estado, 1946"	Escalona Ramos	 Alberto
"Algunos aspectos no económicos de la integración latinoamericana.-- INSORA, 1969"	Barrera	 Manuel
"Algunos caracteres de la cultura española.-- Espasa Calpe, 1942"	Vossler	 Karl
"Algunos comentarios sobre estados finacieros: particularmente de empresas.-- 4a. ed..-- Ediciones Contables y Administrativas, 1969"	Ríos Zúñiga	 Rafael
"Algunos cuentos.-- Universidad Nacional Autónoma, 1956"	López Portillo y Rojas	 José
"Algunos datos acerca del arte plumaria entre los mayas.-- Imp. Oriente, 1939"	Barrera Vásquez	 Alfredo
"Algunos datos o referencias para la biografía del benemérito general Justo Rufino Barrios....-- se, 1930"	Carranza	 Jesus E.
"Algunos mercados seleccionados de muebles de jardín.-- Centro de Comercio Internacional, 1978"	s/a	
"Algunos problemas actuales del socialismo.-- Siglo XXI, 1971"	Sweezy	 Paul M.
"Algunos problemas de bioquímica veterinaria.-- Instituto Español de Fisiologia y bioquimica, 1950"	Seekles	 L.
"Algunos sueños salvadoreños y tres cuentos.-- Editorial García, 2000"	Garay	 Vidal
"Algunos tratados en La Habana.-- Anagrama, 1971"	Lezama Lima	 José
"Algunos tratados en La Habana.-- Anagrama, 1971"	s/a	
"Ali baba and the forty robbers.-- Cooperativa Editorial Magisterio, 1997"	Young	 Vici
"Alianza Centroamericana para el Desarrollo Sostenible.-- Comisión Centroamericana de Ambiente y Desarrollo, 1994"	Comisión Centroamericana de Ambiente y Desarrollo	
"Alianza Centroamericana para el Desarrollo Sostenible.-- Comisión Centroamericana de Ambiente y Desarrollo, 1994"	s/a	
"Alianza Centroamericana para el Desarrollo Sostenible.-- Comisión Centroamericana de Ambiente y Desarrollo, 1994"	s/a	
"Alianza de mis manos.-- Edit. Universitaria, 1970"	Bogrand	 Ricardo
"Alianza de mis manos.-- Edit. Universitaria, 1970"	s/a	
"Alianza de mis manos.-- Edit. Universitaria, 1970"	s/a	
"Alianza de mis manos.-- Edit. Universitaria, 1970"	s/a	
"Alianza de mis manos.-- Universitaria, 1970"	Bogrand	Ricardo
"Alianza para el progreso evaluación del plan de la nación.-- Comité de los nueve, 1966"	s/a	
"Alicante y el comercio de la nieve en la edad moderna.-- Universidad de Alicante, 1990"	Mallol Ferrándiz	 José
"Alice in wonderland : authoritative texts of Alice's adventures in wonderland through the looking-glass the hunting of the snark bakgrounds essays in criticism.-- W. W. Norton, 1971"	Dogson	 Charles Lutwidge
"Alienation : a casebook.-- Thomas y Crowell, 1969"	Burrows	 David I.
"Alma enferma.-- Ministerio de Educación Pública, 1961, 1961"	Salazar	 Ramón A.
"Alma patria : cuentos regionales y narraciones de hechos y episodios históricos sucedidos en Centro América.-- 2a. ed.-- José de Pineda Ibarra, 1965"	Rodas M.	 Joaquín
"Alma, ars moriendi.-- Ediciones Cátedra, 1988"	Machado	 Manuel
"Almacén de antiguedades = Canción de navidad y otros cuentos = Historia de dos ciudades.-- Edimat Libros, 2000"	Dickens	 Charles
"Almacén de antiguedades = Canción de navidad y otros cuentos = Historia de dos ciudades.-- Edimat Libros, 2000"	s/a	
"Almacenaje.-- Ediciones Deusto, 1968"	Fernández de Casadevante y Mújica	 José Luis
"Almacenamiento de granos a nivel rural.-- FAO, 1984"	s/a	
"Almadrabas de la costa alicantina.-- Universidad de Alicante, 1982"	Oliver Narbona	 Manuel
"Almanaque de mareas.-- IGN, 1999"	El Salvador. Instituto Geográfico Nacional	
"Almanaque mundial : 1999.-- Editorial Televisa, 1999"	TELEVISA	
"Almanaque mundial : nuevo milenio 2000.-- Editorial Televisa, 1999"	TELEVISA	
"Almanaque mundial : nuevo milenio 2000.-- Editorial Televisa, 1999"	s/a	
"Almas de jóvenes.-- 4a. ed.-- Espasa-Calpe, 1968"	Unamuno	 Miguel de
"Almas errantes.-- Talleres Gráficos, [19..]"	España	 Victor
"Almirante Guillermo Brown.-- Estrada, 1957"	Gianello	 Leoncio
"Alojamiento y tecnología : industrialización abierta.-- Consejo Superior de Investigaciones Científicas : Instituto Eduardo Torroja de la Construcción y del Cemento, 1981"	Salas Serrano	 Julian
"Aloma.-- 1a. ed..-- Alianza Editorial, 1982"	Rodoreda	 Mercé
"Along the Andes.-- Gay and Bird, 1903"	Petrocokino	 Ambrose
"Alrededor de Walker.-- Talleres Tipográficos del Ministerio de Instrucción Pública, 1929"	Calderón R.	 Salvador
"Alta es la noche : Centroamérica ayer, hoy y mañana.-- Ediciones de Cultura Hispánica, 1990"	González-Camino	 Fernando
"Altamerikanische Tonplastik. Das menschenbild der neuen welt.-- Holle, (1965)"	Wuthenau	 Alexander von
"Altamirano puente entre el liberalismo y la revolución.-- Gobierno del Estado de Morelos, 1985"	Ochoa Campos	 Moisés
"Altasombra.-- Ministerio de Cultura. Departamento Editorial, 1958"	Guzmán Cruchaga	 Juan
"Altasombra.-- Ministerio de Cultura. Departamento Editorial, 1958"	s/a	
"Altasombra.-- Ministerio de Cultura. Departamento Editorial, 1958"	s/a	
"Altasombra.-- Ministerio de Cultura. Departamento Editorial, 1958"	s/a	
"Altazor = Temblor de cielo.-- 4a. ed..-- Cátedra, 1988"	Huidobro	 Vicente
"Altazor = Temblor de cielo.-- 4a. ed..-- Cátedra, 1988"	s/a	
"Alternativas creativas frente al comunismo: pautas para el mundo del mañana.-- Editorial Universitaria de Buenos Aires, 1981"	Wilhelm	 Donald
"Alternativas creativas frente al comunismo: pautas para el mundo del mañana.-- Editorial Universitaria de Buenos Aires, 1981"	s/a	
"Alternativas de un socialista.-- Pax-México, 1972"	Thomas	 Norman
"Always go first class.-- Randon House, 1962"	Marks	 Laurence
"All the best in Central America.-- dodd, Mead., 1952, i.e. 1953"	Clark	 Sydney Aylmer
"Amadis de Gaula.-- Ediciones Cátedra, 1987"	Rodríguez de Montalvo	 Garci
"Amadis de Gaula.-- Ediciones Cátedra, 1987"	s/a	
"Amadises de América: la hazaña de indias como empresa caballeresca.-- Centro de Estudios Latinoamericanos ""Rómulo Gallegos"", 1977"	Rodríguez Prampolini	 Ida
"Amalia.-- Bedout, 1977"	Mármol	 José
"Amalia.-- Kapelusz, 1968"	Mármol	 José
"Amar : enfoque psicológico.-- Compañía Editorial Continental, 1975"	Miller	 Howard L.
"Ambiente, sociedad y naturaleza entre la teoría social y la historia.-- Universidad Nacional de Quilmes, 2002"	Galafassi	 Guido P.
"Amén.-- Offset Ricaldone, 2000"	Bruni	 Corina
"Amen-Hotep III : el esplendor de Egipto : una tesis de  reconstrucción histórica.-- Alderabán, 1998"	Martín Valentín	 Francisco J.
"América :la lucha por la libertad.-- Siglo Veintiuno, 1980"	Hostos	 Eugenio María de
"América :la lucha por la libertad.-- Siglo Veintiuno, 1980"	s/a	
"America and the world revolution. Public lectures delivered et the University of Pennsylvania, spring 1961.-- Oxford University Press, 1963"	Toynbee	 Arnold Joseph
"América bajo la lupa.-- EDAF, 1970"	Noel	 Eugenio
"América del Norte : geografía histórica, económica y regional.-- Omega, 1951"	Jones	 Ll. Rodwell
"América del Norte : geografía histórica, económica y regional.-- Omega, 1951"	Bryan	 P. W.
"América del Sur; geografía económica y regional con un capítulo histórico.-- Omega, 1954"	Shanahan	 E. W.
"América en la historia.-- Fondo de Cultura Económica, 1957"	Zea	 Leopoldo
"América en sus novelas.-- Ediciones Cultura Hispánica del Instituto de Cooperación Iberoamericana, 1983"	Morales	 Padrón
"América en sus novelas.-- Ediciones Cultura Hispánica del Instituto de Cooperación Iberoaméricana, 1983"	Morales Padrón	 Francisco
"America faces south.-- Dodd Mead and company, 1939"	Ybarra	 Thomas Russell
"America hisspana, a portrait and a prospect.-- Charles Scribner´s sons, 1931"	Franck	 Waldo David
"America i the twentieth century.-- Alfred A. Knopf, 1963"	Freidel	 Frank Burt
"América in perspective: the United States through foreing eyes.-- New American Library, 1964"	Commager	 Henry Steele
"América intelectual. Ideas en marcha.-- Guillermo Kraft, [1958]"	Gargill	 Oscar
"América intelectual. Ideas en marcha.-- Guillermo Kraft, [1958]"	s/a	
"América Latina : antiguas culturas precolombinas.-- 4a ed., c1973"	Séjourne	 Laurette
"América Latina : historia, economía, partidos políticos.-- Progreso, 1972"	Tarásov	 K.
"América Latina : la revolución económica y social actual.-- McGraw-Hill, 1964"	Powelson	 John P.
"América Latina : la revolución económica y social actual.-- McGraw-Hill, 1964"	s/a	
"América Latina : teoría y realidad : articulos de pensamiento critico, [S. f.]"	s/a	
"América Latina : veinte repúblicas una nacion.-- Emecé, 1966"	Rosarios	 Ottocar
"América Latina en busca de una identidad : modelos del ensayo ideológico hispanoamericano, 1890-1960.-- Monte Avila Editores, 1969"	Stabb	 Martín S.
"América Latina en busca de una identidad : modelos del ensayo ideológico hispanoamericano, 1890-1960.-- Monte Avila Editores, 1969"	s/a	
"América Latina en el sistema político internacional.-- 3a. ed..-- Ediciones Gernika, 1992"	Atkins	 G. Pope
"América Latina en el sistema político internacional.-- Gernika, 1980"	Atkins	 G. Pope
"América Latina en los ochenta.-- Ediciones Cultura Hispánica, 1986"	Murillo Viaña	 Fernando
"América Latina en su literatura.-- 2a. ed.-- Siglo Veintiuno, 1974"	Fernández Moreno	 César
"América Latina en su literatura.-- 2a. ed.-- Siglo Veintiuno, 1974"	s/a	
"América Latina en sus artes.-- Siglo Veintiuno, 1974"	s/a	
"América Latina en sus artes.-- Siglo Veintiuno, 1974"	s/a	
"América Latina en sus artes.-- Siglo Veintiuno, 1974"	s/a	
"América Latina integrada.-- Losada, 1964"	Herrera	 Felipe
"América Latina integrada.-- Losada, 1964"	s/a	
"América Latina vista por científicos soviéticos.-- Agencia de Prensa Nóvosti : Ediciones Rumbo, 1975"	Mikoyan	 S. A. comp.
"América Latina y Desarrollo social..-- 2a. ed..-- Centro para el desarrollo Económico y Social de América Latina, 1966"	s/a	
"América Latina y el Caribe: perspectivas de su reconstrucción.-- Asociación Latinoamericana de Sociología, 1996"	s/a	
"América Latina y la experiencia europea.-- Industrias Gráficas, 1963"	L.E.C.E.	
"América Latina y la experiencia europea.-- Industrias Gráficas, 1963"	s/a	
"América Latina y liquidez internacioanl.-- CEMLA, 1970"	Centro de Estudios Monetarios Latinoamericanos. Reuniones	
"América Latina y liquidez internacioanl.-- CEMLA, 1970"	s/a	
"América latina y los problemas del desarrollo: la encrucujada del presente y el reto del futuro.-- Monte Avila editores, 1974"	s/a	
"América Latina, crisis y perspectivas.-- Ediciones Cultura Hispánica, 1984"	Van Houtven	 Leo
"América Latina, crisis y perspectivas.-- Ediciones Cultura Hispánica, 1984"	s/a	
"América Latina, crisis y perspectivas.-- Ediciones Cultura Hispánica, 1984"	s/a	
"América Latina, Italia y la comunidad económica europea.-- Giuffre, 1968"	Instituto Italo-Latinoamericano	
"América Latina, Italia y la comunidad económica europea.-- Giuffre, 1968"	s/a	
"América Latina, mundo en revolución.-- Palestra, 1963"	Beals	 carleton
"América Latina: ¿Feudalismo o capitalismo?.-- La Obeja Negra, 1972"	Frank	 Andre Gunder
"América Latina: dependencia y subdesarrollo.-- EDUCA, 1973"	Murga Frasinetti	 Antonio
"América Latina: desarrollo y perspectivas democráticas.-- 1a. ed..-- Ediciones FLACSO, 1982"	Bruna	 Susana
"América Latina: historia de medio siglo.-- Siglo XXI, 1977"	s/a	
"América LAtina: la dominación colonial: selección de elcturas para estudiantes de ciencias sociales.-- Ed. universitaria, 1978"	Godínez	 Carlos A.
"América LAtina: la dominación colonial: selección de elcturas para estudiantes de ciencias sociales.-- Ed. universitaria, 1978"	Godínez	 Carlos A.
"América Latina: militares y sociedad.-- FLACSO, 1991"	s/a	
"América Latina: militares y sociedad.-- FLACSO, 1991"	s/a	
"América Latina: mitos y realidades.-- Poligráfica Argentina, 1962"	Berle	 Adolph Augustus
"América Latina: mitos y realidades.-- Poligráfica Argentina, 1962"	s/a	
"América latina: opción y esperanza.-- Pomaire, 1977"	Frei	 Eduardo
"América Latina; ¿evolución o explosión?.-- Libreros Mexicanos Unidos, 1964"	Adams	 Mildred
"América mágica: los hombres y los meses.-- Sudamericana, 1961"	Arciniegas	 Germán
"América precolombina.-- Time-Life International, 1968"	Leonard	 Jonathan Norton
"América y sus problemas económicos y sociales. Conferencias.-- s.e., 1960"	Conferencia Interamericana	 11a. Quito
"América, cuarta dimensión: los estruscos salieron de los Andes.-- Monte Avila Editores, 1969"	Tariffi	 Natalia Rosi de
"América, fábulas de fábulas y otros ensayos.-- Monte Avila, 1972"	Asturias	 Miguel Angel
"América, Tierra Firma.-- Sudamericana, 1966"	Arciniegas	 Gemán
"América.-- Emecé, 1966"	Maritain	 Jacques
"America: ideal and reality: the United States of 1776 in contemporary european philosophy.-- Kegan Paul, 1947"	Stark	 Werner
"American agricultural origins: a consideration of nature and culture.-- University, 1936"	Seuer	 Carl Ortwin
"American antiquities and researches into the origin and history of the red race.-- Dayton and Saxton; Boston. Saxton and Pierce, 1841"	Bradford	 Alexander Warfield
"American antiquities, being the....-- The Bancroft company, 1921?"	Bancroft	 Hubert Howe
"American biography: or, an historical account of those persons who have.-- Newbury Street, 1704-98"	Belknap	 Jeremy
"American democracy in world perspecxtive.-- Harper and Row, 1967"	s/a	
"American democracy in world perspecxtive.-- Harper and Row, 1967"	s/a	
"American English Course.-- 1a. ed..-- Instituto Méxicano Norteaméricano de Relaciones Culturales, 1957"	Instituto Méxicano Norteaméricano de Relaciones Culturales	
"American English Course.-- Instituto Mexicano-Norteamericano de Relaciones Culturales, 1960"	s/a	
"American English Course.-- Instituto Mexicano-Norteamericano de Relaciones Culturales, 1960"	s/a	
"American English Course.-- Instituto Mexicano-Norteamericano de Relaciones Culturales, 1960"	s/a	
"American English Course.-- Instituto Mexicano-Norteamericano de Relaciones Culturales, 1960"	s/a	
"American hero-myths. A study in the native religions of the western continent.-- H.C. Watts and co., 1882"	Brinton	 Daniel Garrison
"American history: a survey.-- Alfred A. Knopf, 1975"	Current	 Ricahrd Nelson
"American history: a survey.-- Alfred A. Knopf, 1975"	s/a	
"American history: a survey.-- Alfred A. Knopf, 1975"	Current	 Ricahrd Nelson
"American humor : a study of the national character.-- Doubleday, 1931"	Rourke	 Constance
"American indian life, by several of its students.-- B.W. Huebsch, inc., 1922"	Parsons	 Elsie Worthington (Clews)
"American indian: an introduction to the anthropology of the new world.-- Peter Smith, 1950"	Wissler	 Clark
"American mammals their lives, habits, and economoc relations.-- McGraw-Hill, 1939"	Hamilton	 Jr.
"American natural history.-- 3a. ed..-- R. W. Pomeroy, 1842"	Godman	 John D.
"American policies abroad Mexico.-- The University of Chicago, 1928"	Rippy	 J. Fred
"American Political thought the philosophip dimension of American statesmanship.-- F.E. Peacock Publishers, 1983"	Frisch	 Morton J.
"American politics : the people and the polity.-- 3a. ed..-- Little, Bronw and Company, 1978"	s/a	
"American politics: The promise of disharmony.-- The Belknap Press of Harvard University Press, 1981"	Huntington	 Samuel P.
"American skyline; the growth and form of our cities and towns.-- New American Library, 1956"	Tunnard	 Christopher
"American sociology : the history of sociology in the Unites States througt 1950.-- Longmans, 1951"	Odum	 Howard W.
"American sources of modern art.-- s.e., 1933"	Nueva York. Museum of Modern Art	
"American through the essay, an anthology for english courses.-- Oxford University Press, 1940"	Johnson	 A. Theodore
"American writing todayAutores Estadounidenses.-- International Communication Agency, 1982"	Kostelanetz	 Richard ed.
"American writing todayAutores Estadounidenses.-- International Communication Agency, 1982"	s/a	
"Americana; comunismo incaico, Araucania, Flirda, Colombiana.-- Librería M. Bozzi, succ. Lattes, 1936"	Giacalone	 Benedetto
"Americanismos.-- Librería Paul Ollendorff, s.f."	Toro y Gisbert	 Miguel de
"Americanos y europeos.-- Ediciones Guadarrama, 1957"	Caballero Calderón	 Eduardo
"Americanos y europeos.-- Ediciones Guadarrama, 1957"	s/a	
"Americans before Columbus.-- Viking Press, 1951"	Baity	 Elizabeth (Chesley)
"America's yesterday.-- J. B. Lippincott Co., 1937"	Brown	 Frederick Martin
"Amerigo y el nuevo mundo.-- Hermes, 1955"	Arciniegas	 German
"Amerigo y el nuevo mundo.-- Hermes, 1955"	s/a	
"Amerigo y el nuevo mundo.-- Hermes, 1955"	s/a	
"Amerika Kültür tarihi; yeni dünyanin eski medeniyeti.-- Ulus Basimevi, [cover 1949]"	Saman	 Bedri Tabir
"Amistades infantiles.-- 3a. ed..-- Ediciones Morata, 1998"	Rubin	 Zick
"Among cannibals an account of four years travels in Australia and of camp life with the aborigines of Queensland.-- John Murray, 1889"	Lumholtz	 Carl
"Among jungle indians.-- M. Joseph, 1962"	Lovgren	 Birger
"Among the indians of Guiana; being sketches chiefly anthropologic from the interior of British Guiana.-- K. Paul Trench and co., 1883"	Im Thurn	 Everard Ferdinand
"Among thieves.-- Doubleday, 1968"	Cuomo	 George
"Amor de jade.-- 2a. ed..-- Clásicos Roxsil, 1997"	Raudales	 Walter
"Amor de jade.-- 2a. ed..-- Clásicos Roxsil, 1997"	s/a	
"Amor dos quince anos, Marilyn.-- 3a. ed..-- Edicións Xerais de Galicia, 1999"	Fernández Paz	 Agustín 
"Amor inmortal.-- Alianza Editorial, 1988"	Petrushévskaia	 Liudmila
"Amor medioeval.-- UCA Editores, 1986"	Rodríguez Díaz	 Rafael Arturo
"Amor medioeval.-- UCA Editores, 1986"	s/a	
"Amores. Arte de amar.-- 2a. ed..-- Ediciones Cátedra, 1997"	Ovidio	
"Amortización, autofinanciamiento y devaluación.-- Aguilar, 1954"	VAlley	 Jean
"Amparo: millo y azucenas.-- Casa de las Américas, 1970"	s/a	
"Amparo: millo y azucenas.-- Casa de las Américas, 1970"	s/a	
"Amparo: millo y azucenas.-- Casa de las Américas, 1970"	Calderón González	 Jorge
"Amphibians and reptiles of the Navajo Country.-- National Youth Administration, 1937"	Eaton	 Theodore H.
"An Account of the conquest of Peru, written by Pedro Sancho Secretary to Pizarro and Scrivener to his army.-- The Cortes Society, 1917"	Sancho	 Pedro
"An account of the european settlements in America in six parts... each part contains an accurate description of the settlements in it, their extent, climate, productions, trade genius and disposition of their inhabitants: the interests of the several powers of Europe with respect to those settlements; and their political and commercial views with regard to each other.-- 3d. ed..-- R. and J. Dodsley, 1760"	Burke	 Edmund
"An account of the european settlements in America in six parts... each part contains an accurate description of the settlements in it, their extent, climate, productions, trade genius and disposition of their inhabitants: the interests of the several powers of Europe with respect to those settlements; and their political and commercial views with regard to each other.-- 3d. ed..-- R. and J. Dodsley, 1760"	s/a	
"An Affair of honor.-- G. P. Putnam's, Sons, 1969"	Wilder	 Robert
"An Affair of honor.-- G. P. Putnam's, Sons, 1969"	s/a	
